Location,Day,Date,two-way,positive N E,negative S W
950109,Wed,1/1/2020,22194,11229,10965
950109,Thu,1/2/2020,41742,21441,20301
950109,Fri,1/3/2020,43662,22175,21487
950109,Sat,1/4/2020,30368,15702,14666
950109,Sun,1/5/2020,27321,12866,14455
950109,Mon,1/6/2020,43927,22525,21402
950109,Tue,1/7/2020,46613,23726,22887
950109,Wed,1/8/2020,46446,23954,22492
950109,Thu,1/9/2020,46789,23968,22821
950109,Fri,1/10/2020,45900,23633,22267
950109,Sat,1/11/2020,28844,14838,14006
950109,Sun,1/12/2020,25117,12946,12171
950109,Mon,1/13/2020,44598,22894,21704
950109,Tue,1/14/2020,45914,23592,22322
950109,Wed,1/15/2020,46139,23664,22475
950109,Thu,1/16/2020,47135,24161,22974
950109,Fri,1/17/2020,46650,23967,22683
950109,Sat,1/18/2020,27714,14383,13331
950109,Sun,1/19/2020,22871,11532,11339
950109,Mon,1/20/2020,39338,20243,19095
950109,Tue,1/21/2020,45663,23443,22220
950109,Wed,1/22/2020,46107,23823,22284
950109,Thu,1/23/2020,46643,23935,22708
950109,Fri,1/24/2020,46528,23980,22548
950109,Sat,1/25/2020,30129,15735,14394
950109,Tue,1/28/2020,45464,23181,22283
950109,Wed,1/29/2020,39017,20600,18417
950109,Fri,1/31/2020,48122,24772,23350
950109,Sat,2/1/2020,31654,16409,15245
950109,Sun,2/2/2020,25373,12988,12385
950109,Mon,2/3/2020,44187,22559,21628
950109,Tue,2/4/2020,45070,23084,21986
950109,Wed,2/5/2020,43306,22364,20942
950109,Thu,2/6/2020,43678,22453,21225
950109,Fri,2/7/2020,47253,24253,23000
950109,Sat,2/8/2020,32500,17033,15467
950109,Sun,2/9/2020,24388,12471,11917
950109,Mon,2/10/2020,43415,21582,21833
950109,Tue,2/11/2020,46900,24123,22777
950109,Wed,2/12/2020,44410,22941,21469
950109,Thu,2/13/2020,45026,22988,22038
950109,Fri,2/14/2020,47676,24642,23034
950109,Sat,2/15/2020,33085,17150,15935
950109,Sun,2/16/2020,26959,13521,13438
950109,Mon,2/17/2020,42907,21983,20924
950109,Tue,2/18/2020,46732,23903,22829
950109,Wed,2/19/2020,47305,24176,23129
950109,Thu,2/20/2020,47630,24262,23368
950109,Fri,2/21/2020,48676,25091,23585
950109,Sat,2/22/2020,34113,17786,16327
950109,Sun,2/23/2020,27250,13784,13466
950109,Mon,2/24/2020,43066,21986,21080
950109,Tue,2/25/2020,46079,23588,22491
950109,Wed,2/26/2020,43555,22246,21309
950109,Thu,2/27/2020,47365,24124,23241
950109,Fri,2/28/2020,49205,25165,24040
950109,Sat,2/29/2020,33634,17598,16036
950109,Sun,3/1/2020,27763,14149,13614
950109,Mon,3/2/2020,44135,22552,21583
950109,Tue,3/3/2020,47195,23878,23317
950109,Wed,3/4/2020,47869,24367,23502
950109,Thu,3/5/2020,48872,24902,23970
950109,Fri,3/6/2020,49753,25603,24150
950109,Sat,3/7/2020,33788,17609,16179
950109,Sun,3/8/2020,27759,14135,13624
950109,Mon,3/9/2020,44544,22723,21821
950109,Tue,3/10/2020,46517,23683,22834
950109,Wed,3/11/2020,47334,24466,22868
950109,Thu,3/12/2020,47367,24179,23188
950109,Fri,3/13/2020,45608,23377,22231
950109,Sat,3/14/2020,25622,13279,12343
950109,Sun,3/15/2020,23337,11908,11429
950109,Mon,3/16/2020,38910,19811,19099
950109,Tue,3/17/2020,37815,19280,18535
950109,Wed,3/18/2020,35322,17969,17353
950109,Thu,3/19/2020,33850,17274,16576
950109,Fri,3/20/2020,33535,16830,16705
950109,Sat,3/21/2020,20675,10469,10206
950109,Sun,3/22/2020,15253,7923,7330
950109,Mon,3/23/2020,29536,15169,14367
950109,Tue,3/24/2020,29738,15266,14472
950109,Wed,3/25/2020,26221,13423,12798
950109,Thu,3/26/2020,26070,13285,12785
950109,Sat,3/28/2020,14511,7315,7196
950109,Sun,3/29/2020,12482,6495,5987
950109,Mon,3/30/2020,24929,12832,12097
950109,Tue,3/31/2020,25968,13260,12708
950109,Wed,4/1/2020,26346,13545,12801
950109,Thu,4/2/2020,26112,13262,12850
950109,Fri,4/3/2020,26379,13307,13072
950109,Sat,4/4/2020,15277,7809,7468
950109,Sun,4/5/2020,12917,6718,6199
950109,Mon,4/6/2020,25070,12941,12129
950109,Tue,4/7/2020,26060,13437,12623
950109,Wed,4/8/2020,26599,13638,12961
950436,Wed,1/1/2020,11469,5740,5729
950436,Thu,1/2/2020,18371,9093,9278
950436,Fri,1/3/2020,19800,9636,10164
950436,Sat,1/4/2020,15581,7803,7778
950436,Sun,1/5/2020,13785,6944,6841
950436,Mon,1/6/2020,18161,9092,9069
950436,Tue,1/7/2020,18468,9158,9310
950436,Wed,1/8/2020,18958,9324,9634
950436,Thu,1/9/2020,18872,9260,9612
950436,Fri,1/10/2020,20148,9933,10215
950436,Sat,1/11/2020,13568,6645,6923
950436,Mon,1/13/2020,17962,9043,8919
950436,Tue,1/14/2020,18547,9161,9386
950436,Wed,1/15/2020,18364,9011,9353
950436,Thu,1/16/2020,18936,9280,9656
950436,Fri,1/17/2020,19608,9593,10015
950436,Sat,1/18/2020,12312,6023,6289
950436,Sun,1/19/2020,11415,5650,5765
950436,Mon,1/20/2020,17445,8839,8606
950436,Tue,1/21/2020,18296,9079,9217
950436,Wed,1/22/2020,19055,9542,9513
950436,Thu,1/23/2020,18329,8981,9348
950436,Fri,1/24/2020,19467,9456,10011
950436,Sat,1/25/2020,14557,7161,7396
950436,Tue,1/28/2020,18669,9253,9416
950436,Wed,1/29/2020,18753,9282,9471
950436,Thu,1/30/2020,19020,9148,9872
950436,Fri,1/31/2020,20132,9762,10370
950436,Sat,2/1/2020,15337,7553,7784
950436,Sun,2/2/2020,12667,6377,6290
950436,Mon,2/3/2020,18093,9099,8994
950436,Tue,2/4/2020,18698,9231,9467
950436,Wed,2/5/2020,18044,8733,9311
950436,Thu,2/6/2020,17137,8308,8829
950436,Fri,2/7/2020,20286,9920,10366
950436,Sat,2/8/2020,15383,7573,7810
950436,Sun,2/9/2020,12490,6303,6187
950436,Mon,2/10/2020,17993,9060,8933
950436,Tue,2/11/2020,19390,9599,9791
950436,Wed,2/12/2020,18503,9159,9344
950436,Thu,2/13/2020,16121,7761,8360
950436,Fri,2/14/2020,20041,9505,10536
950436,Sat,2/15/2020,16158,7916,8242
950436,Sun,2/16/2020,14389,7316,7073
950436,Mon,2/17/2020,18469,9281,9188
950436,Tue,2/18/2020,18684,9332,9352
950436,Wed,2/19/2020,19475,9569,9906
950436,Thu,2/20/2020,19300,9410,9890
950436,Fri,2/21/2020,21097,10260,10837
950436,Sat,2/22/2020,17674,8756,8918
950436,Sun,2/23/2020,14340,7173,7167
950436,Mon,2/24/2020,18178,9091,9087
950436,Tue,2/25/2020,17554,8664,8890
950436,Wed,2/26/2020,15466,7628,7838
950436,Thu,2/27/2020,19233,9319,9914
950436,Fri,2/28/2020,22174,10834,11340
950436,Sat,2/29/2020,17449,8595,8854
950436,Sun,3/1/2020,14935,7462,7473
950436,Mon,3/2/2020,18716,9342,9374
950436,Tue,3/3/2020,19410,9522,9888
950436,Wed,3/4/2020,19969,9765,10204
950436,Thu,3/5/2020,20030,9756,10274
950436,Fri,3/6/2020,21289,10377,10912
950436,Sat,3/7/2020,17361,8679,8682
950436,Sun,3/8/2020,15474,7740,7734
950436,Mon,3/9/2020,18327,9263,9064
950436,Tue,3/10/2020,19104,9550,9554
950436,Wed,3/11/2020,19355,9479,9876
950436,Thu,3/12/2020,19762,9623,10139
950436,Fri,3/13/2020,21417,10310,11107
950436,Sat,3/14/2020,14928,7374,7554
950436,Sun,3/15/2020,13097,6485,6612
950436,Mon,3/16/2020,17025,8286,8739
950436,Tue,3/17/2020,17327,8583,8744
950436,Wed,3/18/2020,16420,8130,8290
950436,Thu,3/19/2020,16272,7912,8360
950436,Fri,3/20/2020,16599,8057,8542
950436,Sat,3/21/2020,11817,5760,6057
950436,Sun,3/22/2020,8330,4083,4247
950436,Mon,3/23/2020,14085,7118,6967
950436,Tue,3/24/2020,14929,7393,7536
950436,Wed,3/25/2020,13674,6654,7020
950436,Thu,3/26/2020,13510,6462,7048
950436,Sat,3/28/2020,8616,4212,4404
950436,Sun,3/29/2020,7099,3426,3673
950436,Mon,3/30/2020,13044,6519,6525
950436,Tue,3/31/2020,13872,6764,7108
950436,Wed,4/1/2020,13758,6697,7061
950436,Thu,4/2/2020,13940,6809,7131
950436,Fri,4/3/2020,14638,7234,7404
950436,Sat,4/4/2020,9261,4539,4722
950436,Sun,4/5/2020,7807,3743,4064
950436,Mon,4/6/2020,13242,6622,6620
950436,Tue,4/7/2020,14147,6995,7152
950436,Wed,4/8/2020,14039,6907,7132
950507,Wed,1/1/2020,29721,14080,15641
950507,Thu,1/2/2020,36516,18225,18291
950507,Fri,1/3/2020,41970,20109,21861
950507,Sat,1/4/2020,38901,17407,21494
950507,Sun,1/5/2020,35785,15546,20239
950507,Mon,1/6/2020,31888,16039,15849
950507,Tue,1/7/2020,33298,16781,16517
950507,Wed,1/8/2020,34679,17556,17123
950507,Thu,1/9/2020,35350,18028,17322
950507,Fri,1/10/2020,36503,18940,17563
950507,Sat,1/11/2020,28398,14561,13837
950507,Sun,1/12/2020,28460,13556,14904
950507,Mon,1/13/2020,31693,16449,15244
950507,Tue,1/14/2020,34184,17520,16664
950507,Wed,1/15/2020,34184,17390,16794
950507,Thu,1/16/2020,35989,18355,17634
950507,Fri,1/17/2020,41575,21173,20402
950507,Sat,1/18/2020,27736,14326,13410
950507,Sun,1/19/2020,26528,12916,13612
950507,Mon,1/20/2020,33317,16604,16713
950507,Tue,1/21/2020,32621,16451,16170
950507,Wed,1/22/2020,33471,17065,16406
950507,Thu,1/23/2020,34633,17273,17360
950507,Fri,1/24/2020,37632,19015,18617
950507,Sat,1/25/2020,27344,13780,13564
950507,Tue,1/28/2020,32590,16600,15990
950507,Wed,1/29/2020,33858,17507,16351
950507,Thu,1/30/2020,36515,19063,17452
950507,Fri,1/31/2020,39629,20686,18943
950507,Sat,2/1/2020,29444,14999,14445
950507,Sun,2/2/2020,26432,12565,13867
950507,Mon,2/3/2020,31357,15807,15550
950507,Tue,2/4/2020,32304,16341,15963
950507,Wed,2/5/2020,32958,16756,16202
950507,Thu,2/6/2020,33779,17227,16552
950507,Fri,2/7/2020,37785,19493,18292
950507,Sat,2/8/2020,29385,14823,14562
950507,Sun,2/9/2020,28521,13632,14889
950507,Mon,2/10/2020,31170,15851,15319
950507,Tue,2/11/2020,34760,18091,16669
950507,Wed,2/12/2020,35691,18754,16937
950507,Fri,2/14/2020,42838,22531,20307
950507,Sat,2/15/2020,33888,17001,16887
950507,Sun,2/16/2020,32234,14512,17722
950507,Mon,2/17/2020,35962,17258,18704
950507,Tue,2/18/2020,34317,17140,17177
950507,Thu,2/20/2020,37829,19648,18181
950507,Fri,2/21/2020,41791,21602,20189
950507,Sat,2/22/2020,33202,16653,16549
950507,Sun,2/23/2020,32926,15067,17859
950507,Mon,2/24/2020,31739,15822,15917
950507,Tue,2/25/2020,34054,17161,16893
950507,Wed,2/26/2020,32723,16513,16210
950507,Thu,2/27/2020,38106,19474,18632
950507,Fri,2/28/2020,43660,23358,20302
950507,Sat,2/29/2020,35938,18401,17537
950507,Sun,3/1/2020,35968,15256,20712
950507,Mon,3/2/2020,34099,16264,17835
950507,Tue,3/3/2020,35307,17405,17902
950507,Wed,3/4/2020,36153,18213,17940
950507,Thu,3/5/2020,38765,19940,18825
950507,Fri,3/6/2020,47064,25383,21681
950507,Sat,3/7/2020,37313,18722,18591
950507,Sun,3/8/2020,38300,16084,22216
950507,Mon,3/9/2020,33741,16745,16996
950507,Tue,3/10/2020,35510,17614,17896
950507,Wed,3/11/2020,36579,18391,18188
950507,Thu,3/12/2020,39429,20190,19239
950507,Fri,3/13/2020,45049,23426,21623
950507,Sat,3/14/2020,33350,16615,16735
950507,Sun,3/15/2020,32717,14674,18043
950507,Mon,3/16/2020,34130,16715,17415
950507,Tue,3/17/2020,35976,17232,18744
950507,Thu,3/19/2020,34524,16475,18049
950507,Fri,3/20/2020,36642,17691,18951
950507,Sat,3/21/2020,29267,13033,16234
950507,Sun,3/22/2020,22527,9182,13345
950507,Mon,3/23/2020,27398,12875,14523
950507,Tue,3/24/2020,28221,13661,14560
950507,Wed,3/25/2020,26095,12538,13557
950507,Thu,3/26/2020,26031,12464,13567
950507,Fri,3/27/2020,24997,12169,12828
950507,Sat,3/28/2020,18405,8507,9898
950507,Sun,3/29/2020,16819,7037,9782
950507,Mon,3/30/2020,22319,10818,11501
950507,Tue,3/31/2020,24856,12294,12562
950507,Wed,4/1/2020,24798,12174,12624
950507,Thu,4/2/2020,24183,11508,12675
950507,Fri,4/3/2020,23687,11514,12173
950507,Sat,4/4/2020,17162,8076,9086
950507,Sun,4/5/2020,14785,6508,8277
950507,Mon,4/6/2020,21178,10396,10782
950507,Tue,4/7/2020,22756,11079,11677
950507,Wed,4/8/2020,22933,11196,11737
951000,Wed,1/1/2020,1905,922,983
951000,Thu,1/2/2020,2829,1405,1424
951000,Fri,1/3/2020,3133,1592,1541
951000,Sat,1/4/2020,2384,1191,1193
951000,Sun,1/5/2020,2496,1278,1218
951000,Mon,1/6/2020,2883,1461,1422
951000,Tue,1/7/2020,2797,1463,1334
951000,Wed,1/8/2020,2803,1445,1358
951000,Thu,1/9/2020,2932,1554,1378
951000,Fri,1/10/2020,3257,1636,1621
951000,Sat,1/11/2020,1814,887,927
951000,Sun,1/12/2020,2364,1127,1237
951000,Mon,1/13/2020,2953,1447,1506
951000,Tue,1/14/2020,2846,1440,1406
951000,Wed,1/15/2020,2699,1398,1301
951000,Thu,1/16/2020,2966,1591,1375
951000,Fri,1/17/2020,3156,1628,1528
951000,Sat,1/18/2020,1705,838,867
951000,Sun,1/19/2020,1795,924,871
951000,Mon,1/20/2020,2864,1439,1425
951000,Tue,1/21/2020,2863,1501,1362
951000,Wed,1/22/2020,2617,1372,1245
951000,Thu,1/23/2020,2692,1407,1285
951000,Fri,1/24/2020,3027,1535,1492
951000,Sat,1/25/2020,1897,962,935
951000,Tue,1/28/2020,2923,1515,1408
951000,Wed,1/29/2020,2793,1474,1319
951000,Thu,1/30/2020,2937,1546,1391
951000,Fri,1/31/2020,3343,1779,1564
951000,Sat,2/1/2020,2135,1037,1098
951000,Sun,2/2/2020,2160,1123,1037
951000,Mon,2/3/2020,2844,1439,1405
951000,Tue,2/4/2020,2944,1488,1456
951000,Wed,2/5/2020,2668,1411,1257
951000,Thu,2/6/2020,2492,1336,1156
951000,Fri,2/7/2020,3214,1716,1498
951000,Sat,2/8/2020,2154,1066,1088
951000,Sun,2/9/2020,2013,1021,992
951000,Mon,2/10/2020,2859,1428,1431
951000,Wed,2/12/2020,2712,1370,1342
951000,Thu,2/13/2020,2586,1360,1226
951000,Fri,2/14/2020,3318,1750,1568
951000,Sat,2/15/2020,2127,1057,1070
951000,Sun,2/16/2020,2282,1093,1189
951000,Mon,2/17/2020,3129,1584,1545
951000,Tue,2/18/2020,2971,1473,1498
951000,Wed,2/19/2020,2859,1478,1381
951000,Thu,2/20/2020,3065,1601,1464
951000,Fri,2/21/2020,3542,1841,1701
951000,Sat,2/22/2020,2439,1219,1220
951000,Sun,2/23/2020,2610,1347,1263
951000,Mon,2/24/2020,2846,1446,1400
951000,Tue,2/25/2020,2990,1537,1453
951000,Wed,2/26/2020,2509,1346,1163
951000,Thu,2/27/2020,3204,1731,1473
951000,Fri,2/28/2020,3829,2018,1811
951000,Sat,2/29/2020,2484,1253,1231
951000,Sun,3/1/2020,2662,1339,1323
951000,Mon,3/2/2020,2969,1553,1416
951000,Tue,3/3/2020,3290,1700,1590
951000,Wed,3/4/2020,3202,1646,1556
951000,Thu,3/5/2020,3500,1837,1663
951000,Fri,3/6/2020,4055,2129,1926
951000,Sat,3/7/2020,3039,1504,1535
951000,Sun,3/8/2020,3099,1585,1514
951000,Tue,3/10/2020,3955,2006,1949
951000,Wed,3/11/2020,3742,1892,1850
951000,Thu,3/12/2020,3926,2038,1888
951000,Fri,3/13/2020,3918,2085,1833
951000,Sat,3/14/2020,2072,1103,969
951000,Sun,3/15/2020,2234,1170,1064
951000,Mon,3/16/2020,3543,1804,1739
951000,Tue,3/17/2020,3605,1912,1693
951000,Wed,3/18/2020,3191,1684,1507
951000,Thu,3/19/2020,2864,1518,1346
951000,Fri,3/20/2020,3550,1829,1721
951000,Sat,3/21/2020,2439,1259,1180
951000,Sun,3/22/2020,1431,795,636
951000,Mon,3/23/2020,2782,1471,1311
951000,Tue,3/24/2020,2970,1535,1435
951000,Wed,3/25/2020,2975,1548,1427
951000,Thu,3/26/2020,2948,1538,1410
951000,Fri,3/27/2020,2454,1304,1150
951000,Sat,3/28/2020,1180,593,587
951000,Sun,3/29/2020,1250,699,551
951000,Mon,3/30/2020,2743,1398,1345
951000,Tue,3/31/2020,2640,1366,1274
951000,Wed,4/1/2020,2924,1530,1394
951000,Thu,4/2/2020,2983,1578,1405
951000,Fri,4/3/2020,3324,1669,1655
951000,Sat,4/4/2020,1776,901,875
951000,Sun,4/5/2020,1538,844,694
951000,Mon,4/6/2020,3273,1628,1645
951000,Tue,4/7/2020,3297,1694,1603
951000,Wed,4/8/2020,3356,1742,1614
951200,Wed,1/1/2020,11487,5823,5664
951200,Thu,1/2/2020,14887,7502,7385
951200,Fri,1/3/2020,16555,8237,8318
951200,Sat,1/4/2020,13997,7070,6927
951200,Sun,1/5/2020,13434,6928,6506
951200,Mon,1/6/2020,14308,7378,6930
951200,Tue,1/7/2020,15072,7504,7568
951200,Wed,1/8/2020,15143,7741,7402
951200,Thu,1/9/2020,15191,7718,7473
951200,Fri,1/10/2020,16155,8257,7898
951200,Sat,1/11/2020,11256,5514,5742
951200,Sun,1/12/2020,12314,6376,5938
951200,Mon,1/13/2020,13917,7111,6806
951200,Tue,1/14/2020,14844,7578,7266
951200,Wed,1/15/2020,14773,7487,7286
951200,Thu,1/16/2020,15891,8029,7862
951200,Fri,1/17/2020,15685,7971,7714
951200,Sat,1/18/2020,10409,5108,5301
951200,Sun,1/19/2020,10711,5250,5461
951200,Mon,1/20/2020,15024,7682,7342
951200,Tue,1/21/2020,14879,7599,7280
951200,Wed,1/22/2020,14664,7657,7007
951200,Thu,1/23/2020,14597,7391,7206
951200,Fri,1/24/2020,15978,8066,7912
951200,Sat,1/25/2020,11340,5737,5603
951200,Tue,1/28/2020,14697,7504,7193
951200,Wed,1/29/2020,14988,7694,7294
951200,Thu,1/30/2020,15797,8014,7783
951200,Fri,1/31/2020,17010,8557,8453
951200,Sat,2/1/2020,12699,6349,6350
951200,Sun,2/2/2020,11515,5791,5724
951200,Mon,2/3/2020,13990,7187,6803
951200,Tue,2/4/2020,14688,7593,7095
951200,Wed,2/5/2020,13201,6731,6470
951200,Thu,2/6/2020,14297,7328,6969
951200,Fri,2/7/2020,16716,8454,8262
951200,Sat,2/8/2020,13065,6761,6304
951200,Sun,2/9/2020,12193,6270,5923
951200,Mon,2/10/2020,14371,7325,7046
951200,Tue,2/11/2020,15504,8049,7455
951200,Wed,2/12/2020,14396,7579,6817
951200,Thu,2/13/2020,14894,7533,7361
951200,Fri,2/14/2020,17941,8931,9010
951200,Sat,2/15/2020,13732,6654,7078
951200,Sun,2/16/2020,14105,6858,7247
951200,Mon,2/17/2020,15643,7951,7692
951200,Tue,2/18/2020,15355,7832,7523
951200,Wed,2/19/2020,15698,7954,7744
951200,Thu,2/20/2020,16067,8019,8048
951200,Fri,2/21/2020,17976,9086,8890
951200,Sat,2/22/2020,13944,7133,6811
951200,Sun,2/23/2020,14017,7032,6985
951200,Mon,2/24/2020,14188,7171,7017
951200,Tue,2/25/2020,14655,7466,7189
951200,Wed,2/26/2020,13789,6955,6834
951200,Thu,2/27/2020,16714,8321,8393
951200,Fri,2/28/2020,18302,9157,9145
951200,Sat,2/29/2020,14491,7298,7193
951200,Sun,3/1/2020,14872,7504,7368
951200,Mon,3/2/2020,15033,7601,7432
951200,Tue,3/3/2020,15541,7774,7767
951200,Wed,3/4/2020,16048,8147,7901
951200,Thu,3/5/2020,17285,8753,8532
951200,Fri,3/6/2020,19250,9657,9593
951200,Sat,3/7/2020,15023,7672,7351
951200,Sun,3/8/2020,15023,7592,7431
951200,Mon,3/9/2020,14910,7455,7455
951200,Tue,3/10/2020,16179,8056,8123
951200,Wed,3/11/2020,16746,8533,8213
951200,Thu,3/12/2020,17870,8838,9032
951200,Fri,3/13/2020,19247,9502,9745
951200,Sat,3/14/2020,12766,6400,6366
951200,Sun,3/15/2020,13371,6734,6637
951200,Mon,3/16/2020,14845,7474,7371
951200,Tue,3/17/2020,15256,7443,7813
951200,Wed,3/18/2020,14828,7245,7583
951200,Thu,3/19/2020,14264,6986,7278
951200,Fri,3/20/2020,14830,7066,7764
951200,Sat,3/21/2020,10649,5118,5531
951200,Sun,3/22/2020,8360,4244,4116
951200,Mon,3/23/2020,10808,5425,5383
951200,Tue,3/24/2020,11624,5721,5903
951200,Wed,3/25/2020,11512,5812,5700
951200,Thu,3/26/2020,11065,5426,5639
951200,Fri,3/27/2020,10747,5126,5621
951200,Sat,3/28/2020,7355,3614,3741
951200,Sun,3/29/2020,6901,3619,3282
951200,Mon,3/30/2020,9725,4740,4985
951200,Tue,3/31/2020,10421,4989,5432
951200,Wed,4/1/2020,10507,5061,5446
951200,Thu,4/2/2020,10282,4835,5447
951200,Fri,4/3/2020,10134,4639,5495
951200,Sat,4/4/2020,6986,3354,3632
951200,Sun,4/5/2020,6560,3332,3228
951200,Mon,4/6/2020,9021,4447,4574
951200,Tue,4/7/2020,10238,5013,5225
951200,Wed,4/8/2020,10487,5071,5416
952000,Mon,3/9/2020,26223,13098,13125
952000,Tue,3/10/2020,26501,13198,13303
952000,Wed,3/11/2020,27357,13680,13677
952000,Thu,3/12/2020,28719,14626,14093
952000,Fri,3/13/2020,30192,15621,14571
952000,Sat,3/14/2020,20127,10555,9572
952000,Sun,3/15/2020,18050,9308,8742
952000,Mon,3/16/2020,25305,12834,12471
952000,Tue,3/17/2020,24387,12432,11955
952000,Wed,3/18/2020,23890,12339,11551
952000,Thu,3/19/2020,24007,12570,11437
952000,Fri,3/20/2020,23790,12600,11190
952000,Sat,3/21/2020,15374,8338,7036
952000,Sun,3/22/2020,12649,6758,5891
952000,Mon,3/23/2020,20549,10506,10043
952000,Tue,3/24/2020,19264,9850,9414
952000,Wed,3/25/2020,16843,8768,8075
952000,Thu,3/26/2020,17037,8949,8088
952000,Fri,3/27/2020,16507,8689,7818
952000,Sat,3/28/2020,9348,4978,4370
952000,Sun,3/29/2020,8242,4235,4007
952000,Mon,3/30/2020,16134,8076,8058
952000,Tue,3/31/2020,16192,8202,7990
952000,Wed,4/1/2020,16252,8333,7919
952000,Thu,4/2/2020,16979,8801,8178
952000,Fri,4/3/2020,17623,9332,8291
952000,Sat,4/4/2020,10653,5431,5222
952000,Sun,4/5/2020,9363,4620,4743
952000,Mon,4/6/2020,16457,8277,8180
952000,Tue,4/7/2020,16300,8137,8163
952000,Wed,4/8/2020,17298,8764,8534
952100,Wed,1/1/2020,5890,2826,3064
952100,Thu,1/2/2020,10290,4763,5527
952100,Fri,1/3/2020,11077,5489,5588
952100,Sat,1/4/2020,8532,4062,4470
952100,Sun,1/5/2020,7036,3439,3597
952100,Mon,1/6/2020,9857,4768,5089
952100,Tue,1/7/2020,10036,4831,5205
952100,Wed,1/8/2020,10560,5029,5531
952100,Thu,1/9/2020,10902,5154,5748
952100,Fri,1/10/2020,11293,5232,6061
952100,Sat,1/11/2020,8841,3969,4872
952100,Mon,1/13/2020,10075,4839,5236
952100,Tue,1/14/2020,10423,5044,5379
952100,Wed,1/15/2020,10467,5028,5439
952100,Thu,1/16/2020,11088,5248,5840
952100,Fri,1/17/2020,11648,5651,5997
952100,Sat,1/18/2020,6815,3283,3532
952100,Sun,1/19/2020,6104,2976,3128
952100,Mon,1/20/2020,9972,4811,5161
952100,Tue,1/21/2020,10471,4902,5569
952100,Wed,1/22/2020,10642,5158,5484
952100,Thu,1/23/2020,10897,5263,5634
952100,Fri,1/24/2020,11456,5383,6073
952100,Tue,1/28/2020,10360,4997,5363
952100,Wed,1/29/2020,10347,5042,5305
952100,Thu,1/30/2020,10973,5267,5706
952100,Fri,1/31/2020,12012,5728,6284
952100,Sat,2/1/2020,8844,4248,4596
952100,Sun,2/2/2020,6912,3336,3576
952100,Mon,2/3/2020,10395,4971,5424
952100,Tue,2/4/2020,10569,5112,5457
952100,Wed,2/5/2020,10205,4799,5406
952100,Thu,2/6/2020,9454,4613,4841
952100,Fri,2/7/2020,11752,5674,6078
952100,Sat,2/8/2020,9131,4265,4866
952100,Sun,2/9/2020,7188,3559,3629
952100,Mon,2/10/2020,10269,4951,5318
952100,Tue,2/11/2020,11007,5208,5799
952100,Wed,2/12/2020,10449,5093,5356
952100,Thu,2/13/2020,9203,4077,5126
952100,Fri,2/14/2020,11946,5897,6049
952100,Sat,2/15/2020,9093,4414,4679
952100,Sun,2/16/2020,7855,3720,4135
952100,Mon,2/17/2020,10338,4932,5406
952100,Tue,2/18/2020,10739,5166,5573
952100,Wed,2/19/2020,10502,5015,5487
952100,Thu,2/20/2020,11143,5438,5705
952100,Fri,2/21/2020,12723,6080,6643
952100,Sat,2/22/2020,10374,4972,5402
952100,Sun,2/23/2020,8320,4098,4222
952100,Mon,2/24/2020,10198,4849,5349
952100,Tue,2/25/2020,10306,4920,5386
952100,Wed,2/26/2020,8603,4116,4487
952100,Thu,2/27/2020,11185,5268,5917
952100,Fri,2/28/2020,12718,6114,6604
952100,Sat,2/29/2020,9546,4643,4903
952100,Sun,3/1/2020,8235,3940,4295
952100,Mon,3/2/2020,10291,4931,5360
952100,Tue,3/3/2020,10631,5073,5558
952100,Wed,3/4/2020,10919,5213,5706
952100,Thu,3/5/2020,11363,5431,5932
952100,Fri,3/6/2020,12567,6000,6567
952100,Mon,3/9/2020,10602,5050,5552
952100,Tue,3/10/2020,10682,5128,5554
952100,Wed,3/11/2020,10795,5193,5602
952100,Thu,3/12/2020,11366,5535,5831
952100,Fri,3/13/2020,12937,6495,6442
952100,Sat,3/14/2020,7436,3754,3682
952100,Sun,3/15/2020,6456,3166,3290
952100,Mon,3/16/2020,9639,4623,5016
952100,Tue,3/17/2020,9490,4589,4901
952100,Wed,3/18/2020,9297,4499,4798
952100,Thu,3/19/2020,9134,4392,4742
952100,Fri,3/20/2020,9537,4606,4931
952100,Sat,3/21/2020,6154,3034,3120
952100,Sun,3/22/2020,4655,2228,2427
952100,Mon,3/23/2020,7905,3873,4032
952100,Tue,3/24/2020,8028,3859,4169
952100,Wed,3/25/2020,6907,3343,3564
952100,Thu,3/26/2020,6979,3318,3661
952100,Fri,3/27/2020,6816,3271,3545
952100,Sat,3/28/2020,3788,1854,1934
952100,Sun,3/29/2020,3032,1463,1569
952100,Mon,3/30/2020,6560,3162,3398
952100,Tue,3/31/2020,6758,3238,3520
952100,Wed,4/1/2020,6888,3354,3534
952100,Thu,4/2/2020,7021,3459,3562
952100,Fri,4/3/2020,7281,3503,3778
952100,Sat,4/4/2020,4212,2025,2187
952100,Sun,4/5/2020,3332,1613,1719
952100,Mon,4/6/2020,6612,3219,3393
952100,Tue,4/7/2020,6913,3353,3560
952100,Wed,4/8/2020,7121,3424,3697
952200,Wed,1/1/2020,5256,2619,2637
952200,Thu,1/2/2020,10993,5601,5392
952200,Fri,1/3/2020,11941,6038,5903
952200,Sat,1/4/2020,8336,4246,4090
952200,Sun,1/5/2020,6041,3031,3010
952200,Mon,1/6/2020,11376,5750,5626
952200,Tue,1/7/2020,11605,5823,5782
952200,Wed,1/8/2020,11588,5885,5703
952200,Thu,1/9/2020,11683,5957,5726
952200,Fri,1/10/2020,12336,6226,6110
952200,Sat,1/11/2020,8458,4282,4176
952200,Sun,1/12/2020,6179,3109,3070
952200,Mon,1/13/2020,11423,5860,5563
952200,Tue,1/14/2020,12271,6246,6025
952200,Wed,1/15/2020,12339,6240,6099
952200,Thu,1/16/2020,12656,6370,6286
952200,Fri,1/17/2020,12591,6409,6182
952200,Sat,1/18/2020,7222,3639,3583
952200,Sun,1/19/2020,5344,2688,2656
952200,Mon,1/20/2020,10328,5203,5125
952200,Tue,1/21/2020,11949,6008,5941
952200,Wed,1/22/2020,11891,5983,5908
952200,Thu,1/23/2020,12175,6122,6053
952200,Fri,1/24/2020,12356,6260,6096
952200,Sat,1/25/2020,8440,4256,4184
952200,Sun,1/26/2020,6261,3151,3110
952200,Mon,1/27/2020,11353,5720,5633
952200,Tue,1/28/2020,11719,5936,5783
952200,Wed,1/29/2020,11938,6023,5915
952200,Thu,1/30/2020,12360,6244,6116
952200,Fri,1/31/2020,12582,6347,6235
952200,Sat,2/1/2020,8750,4434,4316
952200,Sun,2/2/2020,6372,3155,3217
952200,Mon,2/3/2020,11522,5835,5687
952200,Tue,2/4/2020,12048,6069,5979
952200,Wed,2/5/2020,11647,5887,5760
952200,Thu,2/6/2020,10742,5409,5333
952200,Fri,2/7/2020,12320,6269,6051
952200,Sat,2/8/2020,8598,4353,4245
952200,Sun,2/9/2020,5814,2898,2916
952200,Mon,2/10/2020,11241,5696,5545
952200,Tue,2/11/2020,12266,6147,6119
952200,Wed,2/12/2020,11786,6001,5785
952200,Thu,2/13/2020,10892,5533,5359
952200,Fri,2/14/2020,12733,6519,6214
952200,Sat,2/15/2020,9669,4863,4806
952200,Sun,2/16/2020,6782,3350,3432
952200,Mon,2/17/2020,11203,5638,5565
952200,Tue,2/18/2020,11885,5961,5924
952200,Wed,2/19/2020,12091,6125,5966
952200,Thu,2/20/2020,12671,6347,6324
952200,Fri,2/21/2020,12961,6551,6410
952200,Sat,2/22/2020,9425,4746,4679
952200,Sun,2/23/2020,6709,3382,3327
952200,Mon,2/24/2020,11554,5788,5766
952200,Tue,2/25/2020,12273,6221,6052
952200,Wed,2/26/2020,10697,5367,5330
952200,Thu,2/27/2020,12012,6071,5941
952200,Fri,2/28/2020,13593,6859,6734
952200,Sat,2/29/2020,10527,5305,5222
952200,Sun,3/1/2020,7277,3650,3627
952200,Mon,3/2/2020,11642,5922,5720
952200,Tue,3/3/2020,12388,6265,6123
952200,Wed,3/4/2020,12719,6406,6313
952200,Thu,3/5/2020,12864,6480,6384
952200,Fri,3/6/2020,12904,6487,6417
952200,Sat,3/7/2020,9801,4916,4885
952200,Sun,3/8/2020,6778,3405,3373
952200,Mon,3/9/2020,11297,5696,5601
952200,Tue,3/10/2020,11691,5930,5761
952200,Wed,3/11/2020,11886,6023,5863
952200,Thu,3/12/2020,12025,6071,5954
952200,Fri,3/13/2020,12484,6276,6208
952200,Sat,3/14/2020,7399,3783,3616
952200,Sun,3/15/2020,5485,2776,2709
952200,Mon,3/16/2020,10642,5442,5200
952200,Tue,3/17/2020,10694,5424,5270
952200,Wed,3/18/2020,9927,4974,4953
952200,Thu,3/19/2020,10047,5093,4954
952200,Fri,3/20/2020,9688,4877,4811
952200,Sat,3/21/2020,5244,2672,2572
952200,Sun,3/22/2020,3705,1858,1847
952200,Mon,3/23/2020,8495,4298,4197
952200,Tue,3/24/2020,8301,4161,4140
952200,Wed,3/25/2020,6813,3437,3376
952200,Thu,3/26/2020,6750,3392,3358
952200,Fri,3/27/2020,6806,3437,3369
952200,Sat,3/28/2020,3422,1749,1673
952200,Sun,3/29/2020,2736,1371,1365
952200,Mon,3/30/2020,6779,3422,3357
952200,Tue,3/31/2020,6930,3470,3460
952200,Wed,4/1/2020,6970,3587,3383
952200,Thu,4/2/2020,7218,3685,3533
952200,Fri,4/3/2020,7194,3668,3526
952200,Sat,4/4/2020,4057,2077,1980
952200,Sun,4/5/2020,3053,1541,1512
952200,Mon,4/6/2020,7208,3623,3585
952200,Tue,4/7/2020,7190,3656,3534
952200,Wed,4/8/2020,7295,3709,3586
952700,Wed,1/1/2020,8526,4197,4329
952700,Thu,1/2/2020,13309,6451,6858
952700,Fri,1/3/2020,14679,7174,7505
952700,Sat,1/4/2020,11705,5664,6041
952700,Sun,1/5/2020,10717,5331,5386
952700,Mon,1/6/2020,13645,6589,7056
952700,Tue,1/7/2020,14281,6987,7294
952700,Wed,1/8/2020,14903,7367,7536
952700,Thu,1/9/2020,15361,7856,7505
952700,Fri,1/10/2020,16051,8172,7879
952700,Sat,1/11/2020,11572,5738,5834
952700,Sun,1/12/2020,10473,5260,5213
952700,Mon,1/13/2020,14235,6933,7302
952700,Tue,1/14/2020,15236,7408,7828
952700,Wed,1/15/2020,16003,8077,7926
952700,Thu,1/16/2020,16247,8364,7883
952700,Fri,1/17/2020,17566,8816,8750
952700,Sat,1/18/2020,9073,4915,4158
952700,Sun,1/19/2020,10529,5511,5018
952700,Mon,1/20/2020,14291,7001,7290
952700,Tue,1/21/2020,14900,7086,7814
952700,Wed,1/22/2020,15245,7664,7581
952700,Thu,1/23/2020,15624,8019,7605
952700,Fri,1/24/2020,17034,8425,8609
952700,Sat,1/25/2020,11537,5897,5640
952700,Sun,1/26/2020,11771,6398,5373
952700,Mon,1/27/2020,14266,6810,7456
952700,Tue,1/28/2020,14958,7249,7709
952700,Wed,1/29/2020,15479,7784,7695
952700,Thu,1/30/2020,15574,8031,7543
952700,Fri,1/31/2020,16436,8504,7932
952700,Sat,2/1/2020,12315,6420,5895
952700,Sun,2/2/2020,10599,5387,5212
952700,Mon,2/3/2020,14592,7000,7592
952700,Tue,2/4/2020,15518,7645,7873
952700,Wed,2/5/2020,14792,7279,7513
952700,Thu,2/6/2020,14648,7499,7149
952700,Fri,2/7/2020,16797,8693,8104
952700,Sat,2/8/2020,11875,6057,5818
952700,Sun,2/9/2020,10763,5417,5346
952700,Mon,2/10/2020,14756,7125,7631
952700,Tue,2/11/2020,15486,7557,7929
952700,Wed,2/12/2020,15436,7703,7733
952700,Thu,2/13/2020,15044,7862,7182
952700,Fri,2/14/2020,17927,9225,8702
952700,Sat,2/15/2020,12832,6602,6230
952700,Sun,2/16/2020,12478,6106,6372
952700,Mon,2/17/2020,15689,7584,8105
952700,Tue,2/18/2020,15223,7547,7676
952700,Wed,2/19/2020,15704,7879,7825
952700,Thu,2/20/2020,16454,8524,7930
952700,Fri,2/21/2020,17670,9112,8558
952700,Sat,2/22/2020,12778,6601,6177
952700,Sun,2/23/2020,12052,6219,5833
952700,Mon,2/24/2020,14842,7142,7700
952700,Tue,2/25/2020,15608,7573,8035
952700,Wed,2/26/2020,13619,6898,6721
952700,Thu,2/27/2020,16106,8316,7790
952700,Fri,2/28/2020,17515,8990,8525
952700,Sat,2/29/2020,13340,6799,6541
952700,Sun,3/1/2020,12534,6433,6101
952700,Mon,3/2/2020,14833,7115,7718
952700,Tue,3/3/2020,15691,7594,8097
952700,Wed,3/4/2020,16363,8226,8137
952700,Thu,3/5/2020,16553,8568,7985
952700,Fri,3/6/2020,18322,9470,8852
952700,Sat,3/7/2020,13822,7128,6694
952700,Sun,3/8/2020,12711,6661,6050
952700,Mon,3/9/2020,15008,7342,7666
952700,Tue,3/10/2020,15591,7683,7908
952700,Wed,3/11/2020,16342,8155,8187
952700,Thu,3/12/2020,16728,8656,8072
952700,Fri,3/13/2020,17441,9196,8245
952700,Sat,3/14/2020,11841,6100,5741
952700,Sun,3/15/2020,10194,5264,4930
952700,Mon,3/16/2020,14132,6848,7284
952700,Tue,3/17/2020,14647,7330,7317
952700,Wed,3/18/2020,15175,7378,7797
952700,Thu,3/19/2020,15418,7596,7822
952700,Fri,3/20/2020,14606,7279,7327
952700,Sat,3/21/2020,9723,4873,4850
952700,Sun,3/22/2020,7939,3926,4013
952700,Mon,3/23/2020,11643,5360,6283
952700,Tue,3/24/2020,10777,4924,5853
952700,Wed,3/25/2020,10272,4919,5353
952700,Thu,3/26/2020,10175,4938,5237
952700,Fri,3/27/2020,8836,4722,4114
952700,Sat,3/28/2020,5870,3097,2773
952700,Sun,3/29/2020,5048,2647,2401
952700,Mon,3/30/2020,8267,4080,4187
952700,Tue,3/31/2020,8502,4119,4383
952700,Wed,4/1/2020,8808,4525,4283
952700,Thu,4/2/2020,8883,4723,4160
952700,Fri,4/3/2020,8487,4469,4018
952700,Sat,4/4/2020,5977,3041,2936
952700,Sun,4/5/2020,4949,2463,2486
952700,Mon,4/6/2020,7884,3839,4045
952700,Tue,4/7/2020,8426,4314,4112
952700,Wed,4/8/2020,8141,4418,3723
953100,Wed,1/1/2020,20383,10042,10341
953100,Thu,1/2/2020,35152,16979,18173
953100,Fri,1/3/2020,36489,17757,18732
953100,Sat,1/4/2020,30702,15046,15656
953100,Sun,1/5/2020,23837,11850,11987
953100,Mon,1/6/2020,33882,16284,17598
953100,Tue,1/7/2020,35796,17204,18592
953100,Wed,1/8/2020,35720,17118,18602
953100,Thu,1/9/2020,36307,17505,18802
953100,Fri,1/10/2020,35583,17177,18406
953100,Sat,1/11/2020,30178,14758,15420
953100,Sun,1/12/2020,23988,11740,12248
953100,Mon,1/13/2020,34946,16730,18216
953100,Tue,1/14/2020,35300,16991,18309
953100,Wed,1/15/2020,35701,17248,18453
953100,Thu,1/16/2020,35588,17087,18501
953100,Fri,1/17/2020,36320,17564,18756
953100,Sat,1/18/2020,31159,15086,16073
953100,Sun,1/19/2020,22849,11263,11586
953100,Mon,1/20/2020,32684,15986,16698
953100,Tue,1/21/2020,35348,16898,18450
953100,Wed,1/22/2020,35279,16963,18316
953100,Thu,1/23/2020,35693,17149,18544
953100,Fri,1/24/2020,36845,17788,19057
953100,Sat,1/25/2020,30639,14938,15701
953100,Sun,1/26/2020,24429,11953,12476
953100,Mon,1/27/2020,33718,16272,17446
953100,Tue,1/28/2020,34788,16834,17954
953100,Wed,1/29/2020,34968,16835,18133
953100,Thu,1/30/2020,35750,17163,18587
953100,Fri,1/31/2020,37454,18105,19349
953100,Sat,2/1/2020,35585,17338,18247
953100,Sun,2/2/2020,23931,11832,12099
953100,Mon,2/3/2020,34306,16586,17720
953100,Tue,2/4/2020,34374,16412,17962
953100,Wed,2/5/2020,32582,15754,16828
953100,Thu,2/6/2020,32452,15640,16812
953100,Fri,2/7/2020,37674,18134,19540
953100,Sat,2/8/2020,33723,16337,17386
953100,Sun,2/9/2020,22272,10977,11295
953100,Mon,2/10/2020,34746,16730,18016
953100,Tue,2/11/2020,36129,17396,18733
953100,Wed,2/12/2020,33356,16044,17312
953100,Thu,2/13/2020,33362,16028,17334
953100,Fri,2/14/2020,36944,17792,19152
953100,Sat,2/15/2020,33473,16253,17220
953100,Sun,2/16/2020,25727,12710,13017
953100,Mon,2/17/2020,34338,16680,17658
953100,Tue,2/18/2020,35859,17119,18740
953100,Wed,2/19/2020,36674,17601,19073
953100,Sat,2/22/2020,35974,17343,18631
953100,Sun,2/23/2020,26200,12880,13320
953100,Mon,2/24/2020,33565,16209,17356
953100,Tue,2/25/2020,34413,16665,17748
953100,Wed,2/26/2020,32972,15942,17030
953100,Thu,2/27/2020,35947,17264,18683
953100,Fri,2/28/2020,38440,18379,20061
953100,Sat,2/29/2020,35231,17149,18082
953100,Sun,3/1/2020,25794,12510,13284
953100,Mon,3/2/2020,34627,16705,17922
953100,Tue,3/3/2020,37345,17874,19471
953100,Wed,3/4/2020,36859,17770,19089
953100,Thu,3/5/2020,38025,18282,19743
953100,Fri,3/6/2020,38570,18592,19978
953100,Sat,3/7/2020,36373,17799,18574
953100,Sun,3/8/2020,25465,12630,12835
953100,Mon,3/9/2020,34653,16758,17895
953100,Tue,3/10/2020,35076,16977,18099
953100,Wed,3/11/2020,35514,17240,18274
953100,Thu,3/12/2020,35832,17468,18364
953100,Fri,3/13/2020,37464,18162,19302
953100,Sat,3/14/2020,24785,12048,12737
953100,Sun,3/15/2020,20089,9845,10244
953100,Mon,3/16/2020,30176,14710,15466
953100,Tue,3/17/2020,27188,13251,13937
953100,Wed,3/18/2020,24429,11888,12541
953100,Thu,3/19/2020,24396,11825,12571
953100,Fri,3/20/2020,25870,12628,13242
953100,Sat,3/21/2020,18612,9061,9551
953100,Sun,3/22/2020,12468,5971,6497
953100,Mon,3/23/2020,22428,10782,11646
953100,Tue,3/24/2020,22663,11017,11646
953100,Wed,3/25/2020,18313,8913,9400
953100,Thu,3/26/2020,18946,9172,9774
953100,Fri,3/27/2020,19226,9446,9780
953100,Sat,3/28/2020,14094,6848,7246
953100,Sun,3/29/2020,11461,5470,5991
953100,Mon,3/30/2020,19610,9480,10130
953100,Tue,3/31/2020,19487,9447,10040
953100,Wed,4/1/2020,19666,9611,10055
953100,Thu,4/2/2020,20424,9944,10480
953100,Fri,4/3/2020,22296,10821,11475
953100,Sat,4/4/2020,16306,7901,8405
953100,Sun,4/5/2020,11937,5679,6258
953100,Mon,4/6/2020,20202,9775,10427
953100,Tue,4/7/2020,21214,10334,10880
953100,Wed,4/8/2020,21479,10486,10993
953600,Wed,1/1/2020,26913,13818,13095
953600,Thu,1/2/2020,37134,17884,19250
953600,Fri,1/3/2020,39705,18769,20936
953600,Sat,1/4/2020,33044,16213,16831
953600,Sun,1/5/2020,31077,16481,14596
953600,Mon,1/6/2020,34588,17447,17141
953600,Tue,1/7/2020,37364,18399,18965
953600,Wed,1/8/2020,38346,19038,19308
953600,Thu,1/9/2020,38945,19253,19692
953600,Fri,1/10/2020,38957,18781,20176
953600,Sat,1/11/2020,29006,13986,15020
953600,Sun,1/12/2020,30134,15809,14325
953600,Mon,1/13/2020,32635,16200,16435
953600,Tue,1/14/2020,36949,18157,18792
953600,Wed,1/15/2020,37555,18537,19018
953600,Thu,1/16/2020,39377,19546,19831
953600,Fri,1/17/2020,42488,19546,22942
953600,Sat,1/18/2020,28367,13846,14521
953600,Sun,1/19/2020,27729,15248,12481
953600,Mon,1/20/2020,36307,19155,17152
953600,Tue,1/21/2020,36878,18234,18644
953600,Wed,1/22/2020,36030,17067,18963
953600,Fri,1/24/2020,40098,19098,21000
953600,Sat,1/25/2020,30702,15343,15359
953600,Sun,1/26/2020,30593,16826,13767
953600,Mon,1/27/2020,33335,16916,16419
953600,Tue,1/28/2020,36924,18255,18669
953600,Wed,1/29/2020,36935,18584,18351
953600,Thu,1/30/2020,39461,19502,19959
953600,Fri,1/31/2020,40782,19775,21007
953600,Sat,2/1/2020,31578,15682,15896
953600,Sun,2/2/2020,27800,14786,13014
953600,Tue,2/4/2020,37016,18523,18493
953600,Wed,2/5/2020,35876,17512,18364
953600,Thu,2/6/2020,36415,18029,18386
953600,Fri,2/7/2020,39513,19430,20083
953600,Sat,2/8/2020,32437,15937,16500
953600,Sun,2/9/2020,29405,15479,13926
953600,Tue,2/11/2020,37828,18855,18973
953600,Wed,2/12/2020,36462,18112,18350
953600,Thu,2/13/2020,38222,19027,19195
953600,Fri,2/14/2020,41969,19991,21978
953600,Sat,2/15/2020,34659,16984,17675
953600,Sun,2/16/2020,31745,16904,14841
953600,Mon,2/17/2020,38184,19489,18695
953600,Tue,2/18/2020,18735,7804,10931
953600,Wed,2/19/2020,18680,8297,10383
953600,Thu,2/20/2020,39334,19355,19979
953600,Fri,2/21/2020,38786,17014,21772
953600,Sat,2/22/2020,34485,17276,17209
953600,Sun,2/23/2020,32373,17139,15234
953600,Mon,2/24/2020,34282,17497,16785
953600,Tue,2/25/2020,38180,18902,19278
953600,Wed,2/26/2020,36159,17993,18166
953600,Thu,2/27/2020,40344,20272,20072
953600,Fri,2/28/2020,41682,20809,20873
953600,Sat,2/29/2020,34185,16958,17227
953600,Sun,3/1/2020,33068,17531,15537
953600,Mon,3/2/2020,35656,18287,17369
953600,Tue,3/3/2020,39017,19181,19836
953600,Wed,3/4/2020,40311,20106,20205
953600,Thu,3/5/2020,42329,21425,20904
953600,Fri,3/6/2020,45310,22173,23137
953600,Sat,3/7/2020,36078,17849,18229
953600,Sun,3/8/2020,34632,18307,16325
953600,Mon,3/9/2020,36782,18880,17902
953600,Tue,3/10/2020,39499,19520,19979
953600,Wed,3/11/2020,41293,20459,20834
953600,Thu,3/12/2020,42436,21253,21183
953600,Fri,3/13/2020,43699,21376,22323
953600,Sat,3/14/2020,31767,16037,15730
953600,Sun,3/15/2020,31078,16947,14131
953600,Mon,3/16/2020,35730,18359,17371
953600,Tue,3/17/2020,38373,18932,19441
953600,Wed,3/18/2020,36883,18618,18265
953600,Thu,3/19/2020,36029,18133,17896
953600,Fri,3/20/2020,35565,17192,18373
953600,Sat,3/21/2020,27609,13800,13809
953600,Sun,3/22/2020,22375,12155,10220
953600,Mon,3/23/2020,28334,14719,13615
953600,Tue,3/24/2020,31375,15449,15926
953600,Wed,3/25/2020,30520,14923,15597
953600,Thu,3/26/2020,29211,14752,14459
953600,Fri,3/27/2020,27448,13295,14153
953600,Sat,3/28/2020,20118,10062,10056
953600,Sun,3/29/2020,17810,9777,8033
953600,Mon,3/30/2020,25001,12885,12116
953600,Tue,3/31/2020,28605,14095,14510
953600,Wed,4/1/2020,28790,14494,14296
953600,Thu,4/2/2020,28724,14688,14036
953600,Fri,4/3/2020,27291,13399,13892
953600,Sat,4/4/2020,19804,9930,9874
953600,Sun,4/5/2020,16721,9151,7570
953600,Mon,4/6/2020,24124,12659,11465
953600,Tue,4/7/2020,27388,13808,13580
953600,Wed,4/8/2020,26914,13706,13208
954500,Wed,1/1/2020,4572,2309,2263
954500,Thu,1/2/2020,9085,4615,4470
954500,Fri,1/3/2020,9727,4905,4822
954500,Sat,1/4/2020,6636,3368,3268
954500,Sun,1/5/2020,5606,2857,2749
954500,Mon,1/6/2020,9202,4663,4539
954500,Tue,1/7/2020,9708,4857,4851
954500,Wed,1/8/2020,9783,4902,4881
954500,Thu,1/9/2020,9755,4900,4855
954500,Fri,1/10/2020,10148,5133,5015
954500,Sat,1/11/2020,6422,3273,3149
954500,Sun,1/12/2020,5517,2788,2729
954500,Mon,1/13/2020,9534,4802,4732
954500,Tue,1/14/2020,9660,4888,4772
954500,Wed,1/15/2020,9825,4933,4892
954500,Thu,1/16/2020,10152,5107,5045
954500,Fri,1/17/2020,10168,5128,5040
954500,Sat,1/18/2020,5648,2847,2801
954500,Sun,1/19/2020,4803,2449,2354
954500,Mon,1/20/2020,8261,4152,4109
954500,Tue,1/21/2020,9669,4870,4799
954500,Wed,1/22/2020,9855,4985,4870
954500,Thu,1/23/2020,9859,4987,4872
954500,Fri,1/24/2020,10280,5156,5124
954500,Sat,1/25/2020,7227,3637,3590
954500,Sun,1/26/2020,5909,3002,2907
954500,Mon,1/27/2020,9726,4898,4828
954500,Tue,1/28/2020,9539,4759,4780
954500,Wed,1/29/2020,9903,4975,4928
954500,Thu,1/30/2020,10056,5064,4992
954500,Fri,1/31/2020,10526,5298,5228
954500,Sat,2/1/2020,7599,3811,3788
954500,Sun,2/2/2020,5870,2974,2896
954500,Tue,2/4/2020,9791,4933,4858
954500,Wed,2/5/2020,9622,4829,4793
954500,Thu,2/6/2020,8924,4461,4463
954500,Fri,2/7/2020,10218,5166,5052
954500,Sat,2/8/2020,7507,3772,3735
954500,Sun,2/9/2020,5405,2749,2656
954500,Mon,2/10/2020,9683,4857,4826
954500,Tue,2/11/2020,10022,5101,4921
954500,Wed,2/12/2020,9848,4955,4893
954500,Thu,2/13/2020,7656,3886,3770
954500,Fri,2/14/2020,10108,5072,5036
954500,Sat,2/15/2020,7198,3651,3547
954500,Sun,2/16/2020,6035,3061,2974
954500,Mon,2/17/2020,9088,4640,4448
954500,Tue,2/18/2020,9985,5060,4925
954500,Wed,2/19/2020,10058,5116,4942
954500,Thu,2/20/2020,9978,5073,4905
954500,Fri,2/21/2020,10640,5365,5275
954500,Sat,2/22/2020,8329,4217,4112
954500,Sun,2/23/2020,6323,3211,3112
954500,Mon,2/24/2020,9891,4992,4899
954500,Tue,2/25/2020,9473,4762,4711
954500,Wed,2/26/2020,7583,3838,3745
954500,Thu,2/27/2020,9697,4894,4803
954500,Fri,2/28/2020,10658,5364,5294
954500,Sat,2/29/2020,7576,3812,3764
954500,Sun,3/1/2020,6202,3165,3037
954500,Mon,3/2/2020,9963,5041,4922
954500,Tue,3/3/2020,10683,5358,5325
954500,Wed,3/4/2020,10747,5432,5315
954500,Thu,3/5/2020,10381,5202,5179
954500,Fri,3/6/2020,10611,5373,5238
954500,Sat,3/7/2020,8352,4233,4119
954500,Sun,3/8/2020,6482,3251,3231
954500,Mon,3/9/2020,9745,4952,4793
954500,Tue,3/10/2020,10261,5132,5129
954500,Wed,3/11/2020,10101,5093,5008
954500,Thu,3/12/2020,10436,5252,5184
954500,Fri,3/13/2020,10952,5505,5447
954500,Sat,3/14/2020,7107,3566,3541
954500,Sun,3/15/2020,5382,2745,2637
954500,Mon,3/16/2020,8705,4387,4318
954500,Tue,3/17/2020,8575,4317,4258
954500,Wed,3/18/2020,8131,4105,4026
954500,Thu,3/19/2020,7808,3950,3858
954500,Fri,3/20/2020,8296,4195,4101
954500,Sat,3/21/2020,5219,2634,2585
954500,Sun,3/22/2020,3890,1979,1911
954500,Mon,3/23/2020,7326,3703,3623
954500,Tue,3/24/2020,7174,3588,3586
954500,Wed,3/25/2020,6574,3327,3247
954500,Thu,3/26/2020,6545,3306,3239
954500,Fri,3/27/2020,6998,3546,3452
954500,Sat,3/28/2020,4469,2237,2232
954500,Sun,3/29/2020,3593,1819,1774
954500,Mon,3/30/2020,6607,3330,3277
954500,Tue,3/31/2020,6686,3387,3299
954500,Wed,4/1/2020,6802,3445,3357
954500,Thu,4/2/2020,7030,3522,3508
954500,Fri,4/3/2020,7527,3802,3725
954500,Sat,4/4/2020,4219,2126,2093
954500,Sun,4/5/2020,4034,2026,2008
954500,Mon,4/6/2020,6753,3406,3347
954500,Tue,4/7/2020,7523,3750,3773
954500,Wed,4/8/2020,6884,3437,3447
954700,Wed,1/1/2020,18574,8751,9823
954700,Thu,1/2/2020,32548,15633,16915
954700,Fri,1/3/2020,34585,16654,17931
954700,Sat,1/4/2020,23964,11466,12498
954700,Sun,1/5/2020,21688,10322,11366
954700,Mon,1/6/2020,33494,15975,17519
954700,Tue,1/7/2020,34654,16728,17926
954700,Wed,1/8/2020,34962,16880,18082
954700,Thu,1/9/2020,35625,17182,18443
954700,Fri,1/10/2020,35966,17455,18511
954700,Sat,1/11/2020,21808,10584,11224
954700,Sun,1/12/2020,20485,9912,10573
954700,Mon,1/13/2020,33823,16191,17632
954700,Tue,1/14/2020,35221,16965,18256
954700,Wed,1/15/2020,35188,16848,18340
954700,Thu,1/16/2020,35349,17099,18250
954700,Fri,1/17/2020,34243,16712,17531
954700,Sat,1/18/2020,21011,10194,10817
954700,Sun,1/19/2020,18875,8889,9986
954700,Mon,1/20/2020,30383,14423,15960
954700,Tue,1/21/2020,34396,16524,17872
954700,Wed,1/22/2020,35043,16872,18171
954700,Thu,1/23/2020,34083,16584,17499
954700,Fri,1/24/2020,34517,16833,17684
954700,Sat,1/25/2020,24266,11679,12587
954700,Sun,1/26/2020,21416,10145,11271
954700,Mon,1/27/2020,34951,17412,17539
954700,Tue,1/28/2020,34418,16614,17804
954700,Wed,1/29/2020,34739,16769,17970
954700,Thu,1/30/2020,35262,17152,18110
954700,Fri,1/31/2020,35649,17457,18192
954700,Sat,2/1/2020,26149,12591,13558
954700,Sun,2/2/2020,21624,10290,11334
954700,Tue,2/4/2020,34600,16735,17865
954700,Wed,2/5/2020,32180,15717,16463
954700,Thu,2/6/2020,31750,15395,16355
954700,Fri,2/7/2020,35425,17218,18207
954700,Sat,2/8/2020,26775,12969,13806
954700,Sun,2/9/2020,20031,9453,10578
954700,Mon,2/10/2020,33020,15827,17193
954700,Wed,2/12/2020,34160,16517,17643
954700,Thu,2/13/2020,29224,14316,14908
954700,Fri,2/14/2020,34761,17121,17640
954700,Sat,2/15/2020,25870,12564,13306
954700,Sun,2/16/2020,23487,10990,12497
954700,Mon,2/17/2020,32697,15622,17075
954700,Tue,2/18/2020,34755,16693,18062
954700,Wed,2/19/2020,35239,17020,18219
954700,Thu,2/20/2020,35436,17202,18234
954700,Fri,2/21/2020,36675,17825,18850
954700,Sat,2/22/2020,28014,13552,14462
954700,Sun,2/23/2020,23712,11176,12536
954700,Mon,2/24/2020,33722,16234,17488
954700,Tue,2/25/2020,32024,15447,16577
954700,Wed,2/26/2020,29682,14281,15401
954700,Thu,2/27/2020,34891,16953,17938
954700,Fri,2/28/2020,37171,18126,19045
954700,Sat,2/29/2020,28117,13620,14497
954700,Sun,3/1/2020,23481,11209,12272
954700,Mon,3/2/2020,34128,16336,17792
954700,Tue,3/3/2020,35297,17153,18144
954700,Wed,3/4/2020,35568,17220,18348
954700,Thu,3/5/2020,35270,17199,18071
954700,Fri,3/6/2020,36147,17609,18538
954700,Sat,3/7/2020,27724,13369,14355
954700,Sun,3/8/2020,24245,11603,12642
954700,Mon,3/9/2020,33387,15977,17410
954700,Tue,3/10/2020,34460,16571,17889
954700,Wed,3/11/2020,34819,16926,17893
954700,Thu,3/12/2020,35262,17112,18150
954700,Fri,3/13/2020,35588,17323,18265
954700,Sat,3/14/2020,23126,11140,11986
954700,Sun,3/15/2020,19672,9274,10398
954700,Mon,3/16/2020,29230,14162,15068
954700,Tue,3/17/2020,28719,13934,14785
954700,Wed,3/18/2020,26369,12785,13584
954700,Thu,3/19/2020,25684,12543,13141
954700,Fri,3/20/2020,25893,12593,13300
954700,Sat,3/21/2020,16438,7997,8441
954700,Sun,3/22/2020,12041,5859,6182
954700,Mon,3/23/2020,22209,10674,11535
954700,Tue,3/24/2020,23117,11225,11892
954700,Wed,3/25/2020,21882,10634,11248
954700,Thu,3/26/2020,20856,10260,10596
954700,Fri,3/27/2020,20931,10243,10688
954700,Sat,3/28/2020,12452,6035,6417
954700,Sun,3/29/2020,10485,5061,5424
954700,Mon,3/30/2020,20882,10084,10798
954700,Tue,3/31/2020,21325,10422,10903
954700,Wed,4/1/2020,21635,10551,11084
954700,Thu,4/2/2020,21707,10735,10972
954700,Fri,4/3/2020,23141,11243,11898
954700,Sat,4/4/2020,13296,6426,6870
954700,Sun,4/5/2020,11898,5817,6081
954700,Mon,4/6/2020,20968,10167,10801
954700,Tue,4/7/2020,22655,10996,11659
954700,Wed,4/8/2020,21852,10634,11218
954900,Wed,1/1/2020,8112,3708,4404
954900,Thu,1/2/2020,12333,6107,6226
954900,Fri,1/3/2020,12913,6502,6411
954900,Sat,1/4/2020,10141,4987,5154
954900,Sun,1/5/2020,8230,3870,4360
954900,Mon,1/6/2020,11918,5896,6022
954900,Tue,1/7/2020,12385,6164,6221
954900,Wed,1/8/2020,12299,6111,6188
954900,Thu,1/9/2020,13043,6528,6515
954900,Fri,1/10/2020,13091,6731,6360
954900,Sat,1/11/2020,8488,4269,4219
954900,Sun,1/12/2020,7508,3607,3901
954900,Mon,1/13/2020,11736,5786,5950
954900,Tue,1/14/2020,12494,6214,6280
954900,Wed,1/15/2020,12343,6112,6231
954900,Thu,1/16/2020,12658,6371,6287
954900,Fri,1/17/2020,12849,6609,6240
954900,Sat,1/18/2020,8601,4339,4262
954900,Sun,1/19/2020,7230,3309,3921
954900,Mon,1/20/2020,10484,5140,5344
954900,Tue,1/21/2020,11730,5804,5926
954900,Wed,1/22/2020,12213,6147,6066
954900,Thu,1/23/2020,12032,6072,5960
954900,Fri,1/24/2020,12546,6417,6129
954900,Sat,1/25/2020,9273,4738,4535
954900,Sun,1/26/2020,8137,3795,4342
954900,Sat,2/1/2020,10151,5020,5131
954900,Sun,2/2/2020,8671,4009,4662
954900,Mon,2/3/2020,11889,5852,6037
954900,Tue,2/4/2020,11799,5855,5944
954900,Wed,2/5/2020,12208,6076,6132
954900,Sat,2/8/2020,10483,5226,5257
954900,Sun,2/9/2020,7374,3456,3918
954900,Mon,2/10/2020,11633,5691,5942
954900,Tue,2/11/2020,12258,6147,6111
954900,Tue,2/18/2020,12071,6000,6071
954900,Sat,3/7/2020,12186,6141,6045
954900,Sun,3/8/2020,10592,4971,5621
954900,Mon,3/9/2020,12078,6064,6014
954900,Tue,3/10/2020,12343,6190,6153
954900,Wed,3/11/2020,12486,6282,6204
954900,Thu,3/12/2020,12960,6482,6478
954900,Fri,3/13/2020,13138,6669,6469
954900,Sat,3/14/2020,9120,4621,4499
954900,Fri,3/20/2020,9047,4563,4484
954900,Sat,3/21/2020,5357,2661,2696
954900,Wed,3/25/2020,7675,3865,3810
954900,Thu,3/26/2020,6956,3525,3431
954900,Fri,3/27/2020,7290,3643,3647
954900,Sat,3/28/2020,4264,2093,2171
954900,Sun,3/29/2020,3586,1729,1857
954900,Mon,3/30/2020,7115,3532,3583
954900,Tue,3/31/2020,7359,3699,3660
954900,Wed,4/1/2020,7435,3753,3682
954900,Thu,4/2/2020,7339,3667,3672
954900,Fri,4/3/2020,8122,4127,3995
954900,Sat,4/4/2020,4401,2174,2227
954900,Sun,4/5/2020,4278,1992,2286
954900,Mon,4/6/2020,7405,3675,3730
954900,Tue,4/7/2020,7966,3989,3977
954900,Wed,4/8/2020,7318,3628,3690
955200,Wed,1/1/2020,2139,1040,1099
955200,Thu,1/2/2020,3181,1601,1580
955200,Fri,1/3/2020,3579,1786,1793
955200,Sat,1/4/2020,2982,1464,1518
955200,Sun,1/5/2020,2233,1071,1162
955200,Mon,1/6/2020,3460,1744,1716
955200,Tue,1/7/2020,3450,1728,1722
955200,Wed,1/8/2020,3710,1888,1822
955200,Thu,1/9/2020,3565,1825,1740
955200,Fri,1/10/2020,3645,1842,1803
955200,Sat,1/11/2020,2611,1304,1307
955200,Sun,1/12/2020,2429,1207,1222
955200,Mon,1/13/2020,3413,1691,1722
955200,Tue,1/14/2020,3690,1852,1838
955200,Wed,1/15/2020,3564,1797,1767
955200,Thu,1/16/2020,3563,1828,1735
955200,Fri,1/17/2020,3934,2016,1918
955200,Sat,1/18/2020,2698,1378,1320
955200,Sun,1/19/2020,2315,1145,1170
955200,Mon,1/20/2020,3320,1670,1650
955200,Tue,1/21/2020,3453,1750,1703
955200,Wed,1/22/2020,3475,1785,1690
955200,Thu,1/23/2020,3523,1778,1745
955200,Fri,1/24/2020,3859,1988,1871
955200,Sat,1/25/2020,2865,1452,1413
955200,Sun,1/26/2020,2449,1213,1236
955200,Mon,1/27/2020,3277,1646,1631
955200,Tue,1/28/2020,3496,1763,1733
955200,Wed,1/29/2020,3476,1751,1725
955200,Thu,1/30/2020,3610,1811,1799
955200,Fri,1/31/2020,3885,1984,1901
955200,Sat,2/1/2020,3364,1699,1665
955200,Sun,2/2/2020,2615,1280,1335
955200,Tue,2/4/2020,3383,1694,1689
955200,Wed,2/5/2020,3493,1774,1719
955200,Thu,2/6/2020,3610,1827,1783
955200,Fri,2/7/2020,3673,1868,1805
955200,Sat,2/8/2020,2940,1469,1471
955200,Sun,2/9/2020,2511,1225,1286
955200,Mon,2/10/2020,3515,1763,1752
955200,Tue,2/11/2020,3577,1778,1799
955200,Wed,2/12/2020,3521,1761,1760
955200,Thu,2/13/2020,3500,1781,1719
955200,Fri,2/14/2020,3955,2017,1938
955200,Sat,2/15/2020,3318,1676,1642
955200,Sun,2/16/2020,2744,1379,1365
955200,Mon,2/17/2020,3354,1707,1647
955200,Tue,2/18/2020,3403,1692,1711
955200,Wed,2/19/2020,3629,1840,1789
955200,Thu,2/20/2020,3660,1879,1781
955200,Fri,2/21/2020,4005,2043,1962
955200,Sat,2/22/2020,3190,1591,1599
955200,Sun,2/23/2020,2705,1316,1389
955200,Mon,2/24/2020,3359,1713,1646
955200,Tue,2/25/2020,3646,1799,1847
955200,Wed,2/26/2020,3570,1799,1771
955200,Thu,2/27/2020,3613,1857,1756
955200,Fri,2/28/2020,4215,2166,2049
955200,Sat,2/29/2020,3415,1754,1661
955200,Sun,3/1/2020,2800,1367,1433
955200,Mon,3/2/2020,3420,1722,1698
955200,Tue,3/3/2020,3606,1818,1788
955200,Wed,3/4/2020,3785,1948,1837
955200,Thu,3/5/2020,4000,2035,1965
955200,Fri,3/6/2020,3905,2010,1895
955200,Sat,3/7/2020,3444,1728,1716
955200,Sun,3/8/2020,2923,1468,1455
955200,Mon,3/9/2020,3829,1893,1936
955200,Tue,3/10/2020,3649,1849,1800
955200,Wed,3/11/2020,3674,1866,1808
955200,Thu,3/12/2020,3704,1896,1808
955200,Fri,3/13/2020,4002,2017,1985
955200,Sat,3/14/2020,2745,1389,1356
955200,Sun,3/15/2020,2498,1255,1243
955200,Mon,3/16/2020,3347,1714,1633
955200,Tue,3/17/2020,3139,1555,1584
955200,Wed,3/18/2020,3043,1543,1500
955200,Thu,3/19/2020,3022,1519,1503
955200,Fri,3/20/2020,3241,1629,1612
955200,Sat,3/21/2020,2087,1035,1052
955200,Sun,3/22/2020,1717,869,848
955200,Mon,3/23/2020,2941,1495,1446
955200,Tue,3/24/2020,2607,1315,1292
955200,Wed,3/25/2020,2561,1281,1280
955200,Thu,3/26/2020,2608,1304,1304
955200,Fri,3/27/2020,2546,1268,1278
955200,Sat,3/28/2020,1824,917,907
955200,Sun,3/29/2020,1669,858,811
955200,Mon,3/30/2020,2216,1109,1107
955200,Tue,3/31/2020,2099,1030,1069
955200,Wed,4/1/2020,2228,1087,1141
955200,Thu,4/2/2020,2251,1137,1114
955200,Fri,4/3/2020,2337,1152,1185
955200,Sat,4/4/2020,1773,900,873
955200,Sun,4/5/2020,1614,850,764
955200,Mon,4/6/2020,2296,1138,1158
955200,Tue,4/7/2020,2258,1120,1138
955200,Wed,4/8/2020,2220,1127,1093
955400,Wed,1/1/2020,19972,9693,10279
955400,Thu,1/2/2020,30911,15162,15749
955400,Fri,1/3/2020,33190,16318,16872
955400,Sat,1/4/2020,25086,12301,12785
955400,Sun,1/5/2020,22162,11087,11075
955400,Mon,1/6/2020,31696,15480,16216
955400,Tue,1/7/2020,32184,15689,16495
955400,Wed,1/8/2020,32664,16111,16553
955400,Thu,1/9/2020,33669,16662,17007
955400,Fri,1/10/2020,33797,16777,17020
955400,Sat,1/11/2020,22217,10933,11284
955400,Sun,1/12/2020,21677,10667,11010
955400,Mon,1/13/2020,31702,15550,16152
955400,Tue,1/14/2020,28624,15167,13457
955400,Wed,1/15/2020,32714,16078,16636
955400,Fri,1/17/2020,35536,17215,18321
955400,Sat,1/18/2020,24004,11792,12212
955400,Sun,1/19/2020,20410,10192,10218
955400,Mon,1/20/2020,29829,14695,15134
955400,Tue,1/21/2020,31943,15544,16399
955400,Wed,1/22/2020,32307,15888,16419
955400,Thu,1/23/2020,33030,16290,16740
955400,Fri,1/24/2020,33572,16342,17230
955400,Sat,1/25/2020,25652,12644,13008
955400,Sun,1/26/2020,21979,10903,11076
955400,Mon,1/27/2020,30868,15171,15697
955400,Tue,1/28/2020,32084,15645,16439
955400,Wed,1/29/2020,32268,15959,16309
955400,Thu,1/30/2020,33099,16213,16886
955400,Fri,1/31/2020,34224,16810,17414
955400,Sat,2/1/2020,25862,12692,13170
955400,Sun,2/2/2020,20988,10561,10427
955400,Mon,2/3/2020,31972,15770,16202
955400,Tue,2/4/2020,31991,15860,16131
955400,Wed,2/5/2020,31932,15738,16194
955400,Thu,2/6/2020,33027,16136,16891
955400,Fri,2/7/2020,33240,16190,17050
955400,Sat,2/8/2020,24811,12273,12538
955400,Sun,2/9/2020,21115,10475,10640
955400,Mon,2/10/2020,30716,15261,15455
955400,Tue,2/11/2020,33101,16476,16625
955400,Wed,2/12/2020,34005,16920,17085
955400,Thu,2/13/2020,36442,17956,18486
955400,Fri,2/14/2020,39158,19114,20044
955400,Sat,2/15/2020,29171,14116,15055
955400,Sun,2/16/2020,23838,11236,12602
955400,Mon,2/17/2020,32656,16233,16423
955400,Tue,2/18/2020,32055,15512,16543
955400,Wed,2/19/2020,34178,16661,17517
955400,Thu,2/20/2020,34605,16823,17782
955400,Fri,2/21/2020,37002,18088,18914
955400,Sat,2/22/2020,27629,13598,14031
955400,Sun,2/23/2020,23391,11700,11691
955400,Mon,2/24/2020,30413,14994,15419
955400,Tue,2/25/2020,32261,15767,16494
955400,Wed,2/26/2020,32490,16032,16458
955400,Thu,2/27/2020,34177,16633,17544
955400,Fri,2/28/2020,36082,17500,18582
955400,Sat,2/29/2020,28149,13798,14351
955400,Sun,3/1/2020,24966,12434,12532
955400,Mon,3/2/2020,31061,15286,15775
955400,Tue,3/3/2020,33060,16042,17018
955400,Wed,3/4/2020,34357,16844,17513
955400,Thu,3/5/2020,34758,17059,17699
955400,Fri,3/6/2020,37853,18543,19310
955400,Sat,3/7/2020,29187,14668,14519
955400,Sun,3/8/2020,24296,11936,12360
955400,Mon,3/9/2020,31906,15703,16203
955400,Tue,3/10/2020,33063,16215,16848
955400,Wed,3/11/2020,33581,16424,17157
955400,Thu,3/12/2020,33383,16525,16858
955400,Fri,3/13/2020,35342,17132,18210
955400,Sat,3/14/2020,22795,11151,11644
955400,Sun,3/15/2020,19708,9960,9748
955400,Mon,3/16/2020,29100,14233,14867
955400,Tue,3/17/2020,28019,13718,14301
955400,Wed,3/18/2020,26703,13028,13675
955400,Thu,3/19/2020,25721,12621,13100
955400,Fri,3/20/2020,26272,12617,13655
955400,Sat,3/21/2020,16849,8192,8657
955400,Sun,3/22/2020,13097,6749,6348
955400,Mon,3/23/2020,22523,11164,11359
955400,Tue,3/24/2020,21612,10592,11020
955400,Wed,3/25/2020,20601,10102,10499
955400,Thu,3/26/2020,21073,10372,10701
955400,Fri,3/27/2020,20271,9764,10507
955400,Sat,3/28/2020,13184,6382,6802
955400,Sun,3/29/2020,11251,5860,5391
955400,Mon,3/30/2020,20081,9854,10227
955400,Tue,3/31/2020,19359,9440,9919
955400,Wed,4/1/2020,19387,9555,9832
955400,Thu,4/2/2020,19739,9687,10052
955400,Fri,4/3/2020,19809,9587,10222
955400,Sat,4/4/2020,12557,6163,6394
955400,Sun,4/5/2020,10341,5519,4822
955400,Mon,4/6/2020,18862,9353,9509
955400,Tue,4/7/2020,19231,9457,9774
955400,Wed,4/8/2020,19771,9756,10015
955600,Thu,1/2/2020,58882,29007,29875
955600,Fri,1/3/2020,64739,32785,31954
955600,Sat,1/4/2020,56312,29931,26381
955600,Sun,1/5/2020,49632,26885,22747
955600,Mon,1/6/2020,55162,26830,28332
955600,Tue,1/7/2020,57084,27799,29285
955600,Wed,1/8/2020,58900,28615,30285
955600,Thu,1/9/2020,60107,29223,30884
955600,Fri,1/10/2020,60810,29150,31660
955600,Mon,1/13/2020,56080,26838,29242
955600,Tue,1/14/2020,58722,28563,30159
955600,Wed,1/15/2020,59196,28633,30563
955600,Thu,1/16/2020,61753,30032,31721
955600,Fri,1/17/2020,66437,32315,34122
955600,Sun,1/19/2020,40215,20298,19917
955600,Mon,1/20/2020,53165,26231,26934
955600,Tue,1/21/2020,57161,27883,29278
955600,Wed,1/22/2020,58918,28659,30259
955600,Thu,1/23/2020,60413,29498,30915
955600,Fri,1/24/2020,62643,30467,32176
955600,Mon,1/27/2020,54808,26668,28140
955600,Tue,1/28/2020,56679,27822,28857
955600,Wed,1/29/2020,59129,28586,30543
955600,Thu,1/30/2020,62314,29796,32518
955600,Fri,1/31/2020,64759,30919,33840
955600,Sat,2/1/2020,48315,23415,24900
955600,Sun,2/2/2020,42291,21769,20522
955600,Mon,2/3/2020,56485,27661,28824
955600,Tue,2/4/2020,56890,27744,29146
955600,Wed,2/5/2020,58228,28271,29957
955600,Thu,2/6/2020,59207,28780,30427
955600,Fri,2/7/2020,60488,28847,31641
955600,Sat,2/8/2020,47325,23097,24228
955600,Sun,2/9/2020,42674,21950,20724
955600,Mon,2/10/2020,55958,27303,28655
955600,Tue,2/11/2020,59783,28770,31013
955600,Wed,2/12/2020,61077,29225,31852
955600,Thu,2/13/2020,64411,31135,33276
955600,Fri,2/14/2020,68871,32473,36398
955600,Sat,2/15/2020,53053,26051,27002
955600,Sun,2/16/2020,46725,24694,22031
955600,Mon,2/17/2020,59715,30073,29642
955600,Tue,2/18/2020,58420,28783,29637
955600,Wed,2/19/2020,61161,29831,31330
955600,Thu,2/20/2020,63354,30446,32908
955600,Fri,2/21/2020,67252,32212,35040
955600,Sat,2/22/2020,51921,25345,26576
955600,Sun,2/23/2020,47565,25050,22515
955600,Mon,2/24/2020,55382,27334,28048
955600,Tue,2/25/2020,59290,28991,30299
955600,Wed,2/26/2020,58203,28418,29785
955600,Thu,2/27/2020,64365,31020,33345
955600,Fri,2/28/2020,69378,32602,36776
955600,Sat,2/29/2020,55666,27023,28643
955600,Sun,3/1/2020,53357,29147,24210
955600,Mon,3/2/2020,58051,29367,28684
955600,Tue,3/3/2020,60702,30076,30626
955600,Wed,3/4/2020,62370,30595,31775
955600,Thu,3/5/2020,64700,31122,33578
955600,Sat,3/7/2020,57081,27768,29313
955600,Sun,3/8/2020,54099,30000,24099
955600,Mon,3/9/2020,57704,28347,29357
955600,Tue,3/10/2020,59113,29179,29934
955600,Wed,3/11/2020,61959,30320,31639
955600,Thu,3/12/2020,62292,30107,32185
955600,Sat,3/14/2020,48896,24130,24766
955600,Mon,3/16/2020,53972,27148,26824
955600,Tue,3/17/2020,54684,27703,26981
955600,Wed,3/18/2020,52008,26058,25950
955600,Thu,3/19/2020,51051,25924,25127
955600,Fri,3/20/2020,53644,26888,26756
956000,Wed,1/1/2020,8892,4407,4485
956000,Thu,1/2/2020,10304,5144,5160
956000,Fri,1/3/2020,6434,3189,3245
956000,Sat,1/4/2020,5240,2578,2662
956000,Fri,1/10/2020,6443,3165,3278
956000,Sat,1/11/2020,5337,2591,2746
956000,Sun,1/12/2020,9630,4813,4817
956000,Tue,1/14/2020,10032,5062,4970
956000,Wed,1/15/2020,10403,5245,5158
956000,Fri,1/17/2020,6799,3409,3390
956000,Sat,1/18/2020,4908,2439,2469
956000,Sun,1/19/2020,8986,4403,4583
956000,Sun,1/26/2020,9421,4600,4821
956000,Sat,3/14/2020,5995,2941,3054
956000,Sun,3/15/2020,4587,2294,2293
956000,Mon,3/16/2020,8597,4249,4348
956000,Tue,3/17/2020,8204,4065,4139
956000,Wed,3/18/2020,7902,3933,3969
956000,Thu,3/19/2020,7827,3865,3962
956000,Fri,3/20/2020,8474,4192,4282
956000,Sat,3/21/2020,5055,2574,2481
956000,Sun,3/22/2020,2933,1468,1465
956000,Mon,3/23/2020,7342,3669,3673
956000,Tue,3/24/2020,7174,3582,3592
956000,Wed,3/25/2020,6621,3314,3307
956000,Thu,3/26/2020,6818,3478,3340
956000,Fri,3/27/2020,7088,3529,3559
956000,Sat,3/28/2020,4033,2044,1989
956000,Sun,3/29/2020,2867,1445,1422
956000,Mon,3/30/2020,6699,3295,3404
956000,Tue,3/31/2020,6639,3308,3331
956000,Tue,4/7/2020,7000,3457,3543
956000,Wed,4/8/2020,6930,3416,3514
956100,Wed,1/1/2020,10175,5026,5149
956100,Sat,1/4/2020,16216,9548,6668
956100,Sun,1/5/2020,11868,5991,5877
956100,Mon,1/6/2020,15313,7692,7621
956100,Tue,1/7/2020,15965,8055,7910
956100,Wed,1/8/2020,16024,8197,7827
956100,Thu,1/9/2020,18435,10411,8024
956100,Sat,1/11/2020,12593,6960,5633
956100,Sun,1/12/2020,10960,5475,5485
956100,Mon,1/13/2020,14924,7523,7401
956100,Tue,1/14/2020,15872,8048,7824
956100,Thu,1/16/2020,18964,10668,8296
956100,Fri,1/17/2020,18755,10126,8629
956100,Sun,1/19/2020,10078,5287,4791
956100,Mon,1/20/2020,15498,7843,7655
956100,Tue,1/21/2020,17104,9620,7484
956100,Wed,1/22/2020,15821,8197,7624
956100,Thu,1/23/2020,16082,8338,7744
956100,Fri,1/24/2020,16871,8591,8280
956100,Sat,1/25/2020,12480,6548,5932
956100,Sun,1/26/2020,11223,5772,5451
956100,Mon,1/27/2020,15762,8405,7357
956100,Tue,1/28/2020,15544,7884,7660
956100,Wed,1/29/2020,15678,8095,7583
956100,Sat,2/1/2020,12577,6617,5960
956100,Sun,2/2/2020,10016,5179,4837
956100,Mon,2/3/2020,15214,7831,7383
956100,Tue,2/4/2020,15701,7957,7744
956100,Wed,2/5/2020,14991,7597,7394
956100,Thu,2/6/2020,15712,7961,7751
956100,Fri,2/7/2020,17198,8639,8559
956100,Sat,2/8/2020,12343,6456,5887
956100,Sun,2/9/2020,10821,5453,5368
956100,Mon,2/10/2020,14800,7557,7243
956100,Tue,2/11/2020,15811,8201,7610
956100,Wed,2/12/2020,16287,8484,7803
956100,Thu,2/13/2020,17640,8995,8645
956100,Fri,2/14/2020,19993,10112,9881
956100,Sat,2/15/2020,14482,7148,7334
956100,Sun,2/16/2020,12578,5957,6621
956100,Mon,2/17/2020,17142,8848,8294
956100,Tue,2/18/2020,15739,7829,7910
956100,Wed,2/19/2020,16233,8302,7931
956100,Thu,2/20/2020,16896,8647,8249
956100,Fri,2/21/2020,18297,9208,9089
956100,Sat,2/22/2020,13651,6961,6690
956100,Sun,2/23/2020,12610,6390,6220
956100,Mon,2/24/2020,14885,7546,7339
956100,Tue,2/25/2020,15908,8058,7850
956100,Wed,2/26/2020,15987,8078,7909
956100,Thu,2/27/2020,16872,8535,8337
956100,Fri,2/28/2020,18608,9486,9122
956100,Sat,2/29/2020,14458,7382,7076
956100,Sun,3/1/2020,12711,6347,6364
956100,Mon,3/2/2020,15292,7646,7646
956100,Tue,3/3/2020,16770,8334,8436
956100,Wed,3/4/2020,16670,8339,8331
956100,Thu,3/5/2020,17628,8807,8821
956100,Fri,3/6/2020,19730,9987,9743
956100,Sat,3/7/2020,14768,7676,7092
956100,Sun,3/8/2020,12616,6433,6183
956100,Mon,3/9/2020,15533,7803,7730
956100,Tue,3/10/2020,16439,8276,8163
956100,Wed,3/11/2020,16726,8450,8276
956100,Thu,3/12/2020,17186,8794,8392
956100,Fri,3/13/2020,18897,9592,9305
956100,Sat,3/14/2020,12466,6174,6292
956100,Sun,3/15/2020,11090,5687,5403
956100,Mon,3/16/2020,15576,7563,8013
956100,Tue,3/17/2020,15495,7676,7819
956100,Wed,3/18/2020,14843,7438,7405
956100,Thu,3/19/2020,14489,7333,7156
956100,Fri,3/20/2020,14882,7334,7548
956100,Sat,3/21/2020,9400,4682,4718
956100,Sun,3/22/2020,7004,3625,3379
956100,Mon,3/23/2020,10659,5394,5265
956100,Tue,3/24/2020,11207,5503,5704
956100,Wed,3/25/2020,10675,5377,5298
956100,Thu,3/26/2020,10581,5237,5344
956100,Fri,3/27/2020,10175,4907,5268
956100,Sat,3/28/2020,6422,3128,3294
956100,Sun,3/29/2020,5904,3172,2732
956100,Mon,3/30/2020,9788,4857,4931
956100,Tue,3/31/2020,9880,4879,5001
956100,Wed,4/1/2020,9948,5001,4947
956100,Thu,4/2/2020,10246,5135,5111
956100,Fri,4/3/2020,9986,4955,5031
956100,Sat,4/4/2020,6280,3201,3079
956100,Sun,4/5/2020,5456,2879,2577
956100,Mon,4/6/2020,9386,4715,4671
956100,Tue,4/7/2020,9784,4825,4959
956100,Wed,4/8/2020,9854,4968,4886
956200,Wed,1/1/2020,4604,4604,
956200,Thu,1/2/2020,6530,6530,
956200,Fri,1/3/2020,7384,7384,
956200,Sat,1/4/2020,6082,6082,
956200,Sun,1/5/2020,5434,5434,
956200,Mon,1/6/2020,6411,6411,
956200,Tue,1/7/2020,6425,6425,
956200,Wed,1/8/2020,6783,6783,
956200,Thu,1/9/2020,7128,7128,
956200,Fri,1/10/2020,7500,7500,
956200,Sat,1/11/2020,5006,5006,
956200,Sun,1/12/2020,4917,4917,
956200,Mon,1/13/2020,6300,6300,
956200,Tue,1/14/2020,6679,6679,
956200,Wed,1/15/2020,6790,6790,
956200,Thu,1/16/2020,7289,7289,
956200,Fri,1/17/2020,7639,7639,
956200,Sat,1/18/2020,5609,5609,
956200,Sun,1/19/2020,4902,4902,
956200,Mon,1/20/2020,6639,6639,
956200,Tue,1/21/2020,6473,6473,
956200,Fri,1/24/2020,7209,7209,
956200,Sat,1/25/2020,6102,6102,
956200,Sun,1/26/2020,5363,5363,
956200,Mon,1/27/2020,6378,6378,
956200,Tue,1/28/2020,6400,6400,
956200,Wed,1/29/2020,6471,6471,
956200,Thu,1/30/2020,7031,7031,
956200,Fri,1/31/2020,7629,7629,
956200,Sat,2/1/2020,5826,5826,
956200,Sun,2/2/2020,4846,4846,
956200,Mon,2/3/2020,6663,6663,
956200,Tue,2/4/2020,6648,6648,
956200,Wed,2/5/2020,6498,6498,
956200,Thu,2/6/2020,6759,6759,
956200,Fri,2/7/2020,7595,7595,
956200,Sat,2/8/2020,5712,5712,
956200,Sun,2/9/2020,4920,4920,
956200,Mon,2/10/2020,6326,6326,
956200,Tue,2/11/2020,6932,6932,
956200,Wed,2/12/2020,7326,7326,
956200,Thu,2/13/2020,8160,8160,
956200,Fri,2/14/2020,9127,9127,
956200,Sat,2/15/2020,7042,7042,
956200,Sun,2/16/2020,5498,5498,
956200,Mon,2/17/2020,7366,7366,
956200,Tue,2/18/2020,6465,6465,
956200,Wed,2/19/2020,7075,7075,
956200,Thu,2/20/2020,7377,7377,
956200,Fri,2/21/2020,8254,8254,
956200,Sat,2/22/2020,6823,6823,
956200,Sun,2/23/2020,6123,6123,
956200,Mon,2/24/2020,6276,6276,
956200,Tue,2/25/2020,6761,6761,
956200,Wed,2/26/2020,6799,6799,
956200,Thu,2/27/2020,7122,7122,
956200,Fri,2/28/2020,8308,8308,
956200,Sat,2/29/2020,7381,7381,
956200,Sun,3/1/2020,6289,6289,
956200,Mon,3/2/2020,6378,6378,
956200,Tue,3/3/2020,7043,7043,
956200,Wed,3/4/2020,7053,7053,
956200,Thu,3/5/2020,7435,7435,
956200,Fri,3/6/2020,9049,9049,
956200,Sat,3/7/2020,7319,7319,
956200,Sun,3/8/2020,6019,6019,
956200,Mon,3/9/2020,6512,6512,
956200,Tue,3/10/2020,6808,6808,
956200,Wed,3/11/2020,7076,7076,
956200,Thu,3/12/2020,7469,7469,
956200,Fri,3/13/2020,8076,8076,
956200,Sat,3/14/2020,5561,5561,
956200,Sun,3/15/2020,5261,5261,
956200,Mon,3/16/2020,6235,6235,
956200,Tue,3/17/2020,6320,6320,
956200,Wed,3/18/2020,6049,6049,
956200,Thu,3/19/2020,6062,6062,
956200,Fri,3/20/2020,6121,6121,
956200,Sat,3/21/2020,4134,4134,
956200,Sun,3/22/2020,3435,3435,
956200,Mon,3/23/2020,4698,4698,
956200,Tue,3/24/2020,4593,4593,
956200,Wed,3/25/2020,4607,4607,
956200,Thu,3/26/2020,4528,4528,
956200,Fri,3/27/2020,4207,4207,
956200,Sat,3/28/2020,2809,2809,
956200,Sun,3/29/2020,2821,2821,
956200,Mon,3/30/2020,4150,4150,
956200,Tue,3/31/2020,4122,4122,
956200,Wed,4/1/2020,4240,4240,
956200,Thu,4/2/2020,4265,4265,
956200,Fri,4/3/2020,4216,4216,
956200,Sat,4/4/2020,2828,2828,
956200,Sun,4/5/2020,2443,2443,
956200,Mon,4/6/2020,3996,3996,
956200,Tue,4/7/2020,4019,4019,
956200,Wed,4/8/2020,4231,4231,
956300,Wed,1/1/2020,7793,3933,3860
956300,Thu,1/2/2020,15248,7846,7402
956300,Fri,1/3/2020,16098,8337,7761
956300,Sun,1/5/2020,8074,4037,4037
956300,Mon,1/6/2020,16230,8425,7805
956300,Tue,1/7/2020,17072,8852,8220
956300,Wed,1/8/2020,17214,8883,8331
956300,Thu,1/9/2020,17253,8939,8314
956300,Fri,1/10/2020,17136,8910,8226
956300,Sat,1/11/2020,9757,4936,4821
956300,Sun,1/12/2020,8412,4298,4114
956300,Mon,1/13/2020,16791,8683,8108
956300,Tue,1/14/2020,17756,9024,8732
956300,Wed,1/15/2020,17298,8963,8335
956300,Thu,1/16/2020,17660,9188,8472
956300,Fri,1/17/2020,17245,9078,8167
956300,Sat,1/18/2020,10370,5365,5005
956300,Mon,1/20/2020,14425,7483,6942
956300,Tue,1/21/2020,16643,8633,8010
956300,Wed,1/22/2020,16807,8803,8004
956300,Thu,1/23/2020,16931,8835,8096
956300,Fri,1/24/2020,16960,8852,8108
956300,Mon,1/27/2020,15930,8378,7552
956300,Tue,1/28/2020,16795,8770,8025
956300,Wed,1/29/2020,16419,8467,7952
956300,Thu,1/30/2020,16911,8831,8080
956300,Fri,1/31/2020,17732,9233,8499
956300,Sat,2/1/2020,11613,6064,5549
956300,Mon,2/3/2020,16618,8653,7965
956300,Tue,2/4/2020,16648,8511,8137
956300,Wed,2/5/2020,16774,8739,8035
956300,Sat,2/8/2020,11000,5558,5442
956300,Sun,2/9/2020,8098,4008,4090
956300,Mon,2/10/2020,16608,8324,8284
956300,Tue,2/11/2020,17548,8862,8686
956300,Wed,2/12/2020,17136,8657,8479
956300,Thu,2/13/2020,17601,8883,8718
956300,Fri,2/14/2020,17745,9009,8736
956300,Sat,2/15/2020,11316,5739,5577
956300,Sun,2/16/2020,8649,4263,4386
956300,Mon,2/17/2020,16202,8138,8064
956300,Tue,2/18/2020,17423,8741,8682
956300,Wed,2/19/2020,17913,9065,8848
956300,Thu,2/20/2020,18215,9206,9009
956300,Fri,2/21/2020,17916,9069,8847
956300,Sat,2/22/2020,11564,5859,5705
956300,Sun,2/23/2020,8666,4282,4384
956300,Mon,2/24/2020,16469,8287,8182
956300,Tue,2/25/2020,17191,8671,8520
956300,Wed,2/26/2020,17610,8853,8757
956300,Thu,2/27/2020,18031,9120,8911
956300,Fri,2/28/2020,18283,9279,9004
956300,Sat,2/29/2020,12124,6153,5971
956300,Sun,3/1/2020,9008,4430,4578
956300,Mon,3/2/2020,17031,8581,8450
956300,Tue,3/3/2020,18016,9143,8873
956300,Wed,3/4/2020,17891,9096,8795
956300,Thu,3/5/2020,18163,9136,9027
956300,Fri,3/6/2020,18519,9398,9121
956300,Sat,3/7/2020,12252,6195,6057
956300,Sun,3/8/2020,9134,4525,4609
956300,Mon,3/9/2020,16637,8432,8205
956300,Tue,3/10/2020,17279,8705,8574
956300,Wed,3/11/2020,17617,8914,8703
956300,Thu,3/12/2020,16754,8398,8356
956300,Fri,3/13/2020,17595,8957,8638
956300,Sat,3/14/2020,9587,4816,4771
956300,Sun,3/15/2020,7804,3836,3968
956300,Mon,3/16/2020,15080,7565,7515
956300,Tue,3/17/2020,14495,7274,7221
956300,Wed,3/18/2020,13474,6803,6671
956300,Thu,3/19/2020,13150,6601,6549
956300,Fri,3/20/2020,13634,6865,6769
956300,Sat,3/21/2020,7700,3878,3822
956300,Sun,3/22/2020,5379,2658,2721
956300,Mon,3/23/2020,12212,6140,6072
956300,Tue,3/24/2020,11867,5944,5923
956300,Wed,3/25/2020,10969,5510,5459
956300,Thu,3/26/2020,11535,5789,5746
956300,Fri,3/27/2020,11378,5720,5658
956300,Sat,3/28/2020,6477,3327,3150
956300,Sun,3/29/2020,5595,2828,2767
956300,Mon,3/30/2020,11284,5583,5701
956300,Tue,3/31/2020,11123,5581,5542
956300,Wed,4/1/2020,11458,5757,5701
956300,Thu,4/2/2020,11375,5715,5660
956300,Fri,4/3/2020,11504,5817,5687
956300,Sat,4/4/2020,6995,3515,3480
956300,Sun,4/5/2020,5551,2755,2796
956300,Mon,4/6/2020,11187,5569,5618
956300,Tue,4/7/2020,11460,5755,5705
956300,Wed,4/8/2020,11494,5793,5701
956400,Wed,1/1/2020,5160,2628,2532
956400,Thu,1/2/2020,8925,4578,4347
956400,Fri,1/3/2020,9187,4664,4523
956400,Sat,1/4/2020,6642,3410,3232
956400,Sun,1/5/2020,5633,2859,2774
956400,Mon,1/6/2020,9281,4760,4521
956400,Tue,1/7/2020,9778,4954,4824
956400,Wed,1/8/2020,9898,5091,4807
956400,Thu,1/9/2020,9837,5043,4794
956400,Fri,1/10/2020,9410,4789,4621
956400,Sat,1/11/2020,6398,3187,3211
956400,Sun,1/12/2020,5838,2951,2887
956400,Mon,1/13/2020,10111,5191,4920
956400,Tue,1/14/2020,10285,5156,5129
956400,Wed,1/15/2020,10243,5208,5035
956400,Thu,1/16/2020,10066,5034,5032
956400,Fri,1/17/2020,9921,5115,4806
956400,Sat,1/18/2020,6624,3379,3245
956400,Sun,1/19/2020,5474,2761,2713
956400,Mon,1/20/2020,8366,4281,4085
956400,Tue,1/21/2020,10126,5116,5010
956400,Wed,1/22/2020,10315,5209,5106
956400,Thu,1/23/2020,10230,5155,5075
956400,Fri,1/24/2020,10147,5161,4986
956400,Sat,1/25/2020,7037,3560,3477
956400,Sun,1/26/2020,5925,3008,2917
956400,Mon,1/27/2020,9845,5003,4842
956400,Tue,1/28/2020,10151,5126,5025
956400,Wed,1/29/2020,9912,5024,4888
956400,Thu,1/30/2020,10220,5157,5063
956400,Fri,1/31/2020,10232,5224,5008
956400,Sat,2/1/2020,7290,3690,3600
956400,Sun,2/2/2020,6342,3204,3138
956400,Mon,2/3/2020,9825,4990,4835
956400,Tue,2/4/2020,9810,4962,4848
956400,Wed,2/5/2020,9894,5039,4855
956400,Thu,2/6/2020,9816,5029,4787
956400,Fri,2/7/2020,9955,5084,4871
956400,Sat,2/8/2020,7149,3691,3458
956400,Sun,2/9/2020,5565,2801,2764
956400,Mon,2/10/2020,9676,4969,4707
956400,Tue,2/11/2020,10032,5116,4916
956400,Wed,2/12/2020,9794,4972,4822
956400,Thu,2/13/2020,9754,4980,4774
956400,Fri,2/14/2020,10062,5170,4892
956400,Sat,2/15/2020,7078,3539,3539
956400,Sun,2/16/2020,6214,3185,3029
956400,Mon,2/17/2020,9306,4744,4562
956400,Tue,2/18/2020,10112,5135,4977
956400,Wed,2/19/2020,10264,5245,5019
956400,Thu,2/20/2020,10187,5142,5045
956400,Fri,2/21/2020,10355,5248,5107
956400,Sat,2/22/2020,7180,3605,3575
956400,Sun,2/23/2020,6065,3029,3036
956400,Mon,2/24/2020,9261,4742,4519
956400,Sun,3/1/2020,6509,3238,3271
956400,Mon,3/2/2020,9533,4843,4690
956400,Tue,3/3/2020,10473,5358,5115
956400,Wed,3/4/2020,10441,5320,5121
956400,Thu,3/5/2020,10686,5387,5299
956400,Fri,3/6/2020,10909,5536,5373
956400,Sat,3/7/2020,7988,3980,4008
956400,Sun,3/8/2020,6519,3284,3235
956400,Mon,3/9/2020,9595,4896,4699
956400,Tue,3/10/2020,9948,5054,4894
956400,Wed,3/11/2020,10001,5079,4922
956400,Thu,3/12/2020,9310,4713,4597
956400,Fri,3/13/2020,10189,5139,5050
956400,Sat,3/14/2020,6191,3144,3047
956400,Sun,3/15/2020,5533,2795,2738
956400,Mon,3/16/2020,8755,4509,4246
956400,Tue,3/17/2020,8668,4390,4278
956400,Wed,3/18/2020,7905,4027,3878
956400,Thu,3/19/2020,7368,3731,3637
956400,Fri,3/20/2020,8191,4137,4054
956400,Sat,3/21/2020,5414,2653,2761
956400,Sun,3/22/2020,3803,1923,1880
956400,Mon,3/23/2020,7037,3622,3415
956400,Tue,3/24/2020,6671,3336,3335
956400,Wed,3/25/2020,5893,2977,2916
956400,Thu,3/26/2020,6444,3250,3194
956400,Fri,3/27/2020,6378,3217,3161
956400,Sat,3/28/2020,4250,2159,2091
956400,Sun,3/29/2020,3940,2024,1916
956400,Mon,3/30/2020,6520,3296,3224
956400,Tue,3/31/2020,6384,3231,3153
956400,Wed,4/1/2020,6741,3442,3299
956400,Thu,4/2/2020,6808,3498,3310
956400,Fri,4/3/2020,7132,3582,3550
956400,Sat,4/4/2020,4870,2458,2412
956400,Sun,4/5/2020,3955,2017,1938
956400,Mon,4/6/2020,6701,3362,3339
956400,Tue,4/7/2020,6802,3440,3362
956400,Wed,4/8/2020,6784,3412,3372
956500,Wed,1/1/2020,16280,8091,8189
956500,Thu,1/2/2020,26783,13274,13509
956500,Fri,1/3/2020,29396,14517,14879
956500,Sat,1/4/2020,21489,10662,10827
956500,Sun,1/5/2020,17555,8832,8723
956500,Mon,1/6/2020,27635,13675,13960
956500,Tue,1/7/2020,27809,13770,14039
956500,Wed,1/8/2020,29046,14401,14645
956500,Thu,1/9/2020,28764,14229,14535
956500,Fri,1/10/2020,28954,14276,14678
956500,Sat,1/11/2020,18602,9060,9542
956500,Sun,1/12/2020,16993,8377,8616
956500,Mon,1/13/2020,27070,13338,13732
956500,Tue,1/14/2020,28243,13979,14264
956500,Wed,1/15/2020,28593,14138,14455
956500,Thu,1/16/2020,29249,14394,14855
956500,Fri,1/17/2020,30641,15093,15548
956500,Sat,1/18/2020,21417,10339,11078
956500,Sun,1/19/2020,16249,8090,8159
956500,Mon,1/20/2020,24513,12157,12356
956500,Tue,1/21/2020,27742,13585,14157
956500,Wed,1/22/2020,28575,13764,14811
956500,Thu,1/23/2020,28519,13814,14705
956500,Fri,1/24/2020,30310,14486,15824
956500,Sat,1/25/2020,23058,11119,11939
956500,Sun,1/26/2020,17886,8897,8989
956500,Mon,1/27/2020,27672,13530,14142
956500,Tue,1/28/2020,27909,13541,14368
956500,Wed,1/29/2020,28050,13583,14467
956500,Thu,1/30/2020,29808,14430,15378
956500,Fri,1/31/2020,31491,15260,16231
956500,Sat,2/1/2020,24025,11673,12352
956500,Sun,2/2/2020,18156,8852,9304
956500,Mon,2/3/2020,28753,14133,14620
956500,Thu,2/6/2020,28224,13927,14297
956500,Fri,2/7/2020,30521,14956,15565
956500,Sat,2/8/2020,22578,11151,11427
956500,Sun,2/9/2020,17707,8797,8910
956500,Mon,2/10/2020,26796,13196,13600
956500,Tue,2/11/2020,28513,14055,14458
956500,Wed,2/12/2020,28076,13760,14316
956500,Thu,2/13/2020,30235,14889,15346
956500,Fri,2/14/2020,32496,15850,16646
956500,Sat,2/15/2020,24233,11819,12414
956500,Sun,2/16/2020,18474,9142,9332
956500,Mon,2/17/2020,27105,13379,13726
956500,Tue,2/18/2020,25350,12464,12886
956500,Wed,2/19/2020,29083,14314,14769
956500,Thu,2/20/2020,29487,14505,14982
956500,Fri,2/21/2020,31692,15455,16237
956500,Sat,2/22/2020,23602,11574,12028
956500,Sun,2/23/2020,18606,9256,9350
956500,Mon,2/24/2020,26648,13218,13430
956500,Thu,2/27/2020,30534,15068,15466
956500,Fri,2/28/2020,32650,15958,16692
956500,Sat,2/29/2020,25414,12508,12906
956500,Sun,3/1/2020,19879,10041,9838
956500,Mon,3/2/2020,28653,14232,14421
956500,Tue,3/3/2020,30882,15361,15521
956500,Wed,3/4/2020,32140,15778,16362
956500,Thu,3/5/2020,33068,16162,16906
956500,Fri,3/6/2020,35576,17238,18338
956500,Sat,3/7/2020,27116,13315,13801
956500,Sun,3/8/2020,20489,10234,10255
956500,Mon,3/9/2020,30446,15195,15251
956500,Tue,3/10/2020,30844,15259,15585
956500,Wed,3/11/2020,32934,16245,16689
956500,Thu,3/12/2020,31033,15336,15697
956500,Fri,3/13/2020,34832,17023,17809
956500,Sat,3/14/2020,21414,10366,11048
956500,Sun,3/15/2020,18030,8996,9034
956500,Mon,3/16/2020,27230,13661,13569
956500,Tue,3/17/2020,26171,13033,13138
956500,Wed,3/18/2020,23851,11960,11891
956500,Thu,3/19/2020,23068,11470,11598
956500,Fri,3/20/2020,24321,12065,12256
956500,Sat,3/21/2020,15450,7818,7632
956500,Sun,3/22/2020,11156,5702,5454
956500,Mon,3/23/2020,20323,10257,10066
956500,Tue,3/24/2020,18474,9265,9209
956500,Wed,3/25/2020,17317,8675,8642
956500,Thu,3/26/2020,18113,9083,9030
956500,Fri,3/27/2020,17936,9025,8911
956500,Sat,3/28/2020,11732,5880,5852
956500,Sun,3/29/2020,10902,5522,5380
956500,Mon,3/30/2020,17705,8977,8728
956500,Tue,3/31/2020,17213,8682,8531
956500,Wed,4/1/2020,17718,8848,8870
956500,Thu,4/2/2020,17905,9004,8901
956500,Fri,4/3/2020,18547,9205,9342
956500,Sat,4/4/2020,11675,5844,5831
956500,Sun,4/5/2020,9896,5032,4864
956500,Mon,4/6/2020,17423,8753,8670
956500,Tue,4/7/2020,17749,8804,8945
956500,Wed,4/8/2020,17821,8981,8840
956600,Wed,1/1/2020,6026,3051,2975
956600,Sat,1/4/2020,7872,3976,3896
956600,Sun,1/5/2020,6485,3285,3200
956600,Mon,1/6/2020,10535,5285,5250
956600,Tue,1/7/2020,10527,5309,5218
956600,Wed,1/8/2020,10978,5557,5421
956600,Thu,1/9/2020,11148,5661,5487
956600,Fri,1/10/2020,11301,5688,5613
956600,Sat,1/11/2020,7795,3984,3811
956600,Sun,1/12/2020,7233,3606,3627
956600,Mon,1/13/2020,10455,5225,5230
956600,Tue,1/14/2020,11019,5572,5447
956600,Wed,1/15/2020,10917,5478,5439
956600,Thu,1/16/2020,11337,5604,5733
956600,Fri,1/17/2020,11314,5726,5588
956600,Sun,1/19/2020,6228,3168,3060
956600,Tue,1/21/2020,10866,5533,5333
956600,Thu,1/23/2020,10897,5510,5387
956600,Fri,1/24/2020,11200,5717,5483
956600,Sat,1/25/2020,8878,4419,4459
956600,Sun,1/26/2020,6861,3582,3279
956600,Mon,1/27/2020,11025,5496,5529
956600,Tue,1/28/2020,10956,5550,5406
956600,Wed,1/29/2020,10749,5412,5337
956600,Thu,1/30/2020,11157,5595,5562
956600,Fri,1/31/2020,11598,5925,5673
956600,Sat,2/1/2020,8944,4628,4316
956600,Sun,2/2/2020,6778,3418,3360
956600,Mon,2/3/2020,10757,5305,5452
956600,Thu,2/6/2020,10846,5507,5339
956600,Fri,2/7/2020,11072,5663,5409
956600,Sat,2/8/2020,8756,4531,4225
956600,Sun,2/9/2020,6515,3245,3270
956600,Tue,2/11/2020,10724,5398,5326
956600,Wed,2/12/2020,10596,5376,5220
956600,Thu,2/13/2020,11168,5668,5500
956600,Sat,2/15/2020,9043,4665,4378
956600,Sun,2/16/2020,7085,3527,3558
956600,Mon,2/17/2020,10349,5151,5198
956600,Tue,2/18/2020,11000,5560,5440
956600,Wed,2/19/2020,10889,5465,5424
956600,Thu,2/20/2020,11137,5520,5617
956600,Fri,2/21/2020,12182,6210,5972
956600,Sat,2/22/2020,9543,4881,4662
956600,Sun,2/23/2020,6723,3427,3296
956600,Sun,3/1/2020,7473,3733,3740
956600,Mon,3/2/2020,10605,5312,5293
956600,Tue,3/3/2020,11172,5618,5554
956600,Wed,3/4/2020,11290,5672,5618
956600,Thu,3/5/2020,11782,5925,5857
956600,Sun,3/8/2020,7061,3526,3535
956600,Tue,3/10/2020,11183,5613,5570
956600,Fri,3/13/2020,10652,5641,5011
956600,Sat,3/14/2020,7063,3618,3445
956600,Sun,3/15/2020,5737,2822,2915
956600,Mon,3/16/2020,9670,4839,4831
956600,Tue,3/17/2020,9601,4875,4726
956600,Wed,3/18/2020,8880,4456,4424
956600,Thu,3/19/2020,8435,4254,4181
956600,Fri,3/20/2020,8919,4525,4394
956600,Sat,3/21/2020,5342,2722,2620
956600,Sun,3/22/2020,3701,1797,1904
956600,Mon,3/23/2020,7848,3919,3929
956600,Tue,3/24/2020,7460,3720,3740
956600,Wed,3/25/2020,7137,3597,3540
956600,Thu,3/26/2020,7326,3711,3615
956600,Fri,3/27/2020,7129,3638,3491
956600,Sat,3/28/2020,4256,2130,2126
956600,Sun,3/29/2020,3837,1850,1987
956600,Mon,3/30/2020,7271,3644,3627
956600,Tue,3/31/2020,7015,3536,3479
956600,Wed,4/1/2020,7172,3592,3580
956600,Thu,4/2/2020,7175,3610,3565
956600,Fri,4/3/2020,7353,3756,3597
956600,Sat,4/4/2020,4328,2209,2119
956600,Sun,4/5/2020,3542,1749,1793
956600,Mon,4/6/2020,7205,3579,3626
956600,Tue,4/7/2020,7258,3640,3618
956600,Wed,4/8/2020,7333,3723,3610
959999,Wed,1/1/2020,6021,2970,3051
959999,Thu,1/2/2020,11402,5757,5645
959999,Fri,1/3/2020,12225,6104,6121
959999,Sat,1/4/2020,8354,4214,4140
959999,Sun,1/5/2020,6782,3332,3450
959999,Mon,1/6/2020,12262,6176,6086
959999,Tue,1/7/2020,12479,6296,6183
959999,Wed,1/8/2020,12387,6181,6206
959999,Thu,1/9/2020,12565,6320,6245
959999,Fri,1/10/2020,13055,6522,6533
959999,Sat,1/11/2020,8029,3999,4030
959999,Sun,1/12/2020,6547,3313,3234
959999,Mon,1/13/2020,11966,6077,5889
959999,Tue,1/14/2020,12649,6193,6456
959999,Wed,1/15/2020,12158,6075,6083
959999,Thu,1/16/2020,12418,6198,6220
959999,Fri,1/17/2020,13175,6794,6381
959999,Sat,1/18/2020,7932,4034,3898
959999,Sun,1/19/2020,6285,3119,3166
959999,Mon,1/20/2020,10778,5383,5395
959999,Tue,1/21/2020,11744,5911,5833
959999,Wed,1/22/2020,12277,6133,6144
959999,Thu,1/23/2020,11849,6026,5823
959999,Fri,1/24/2020,12491,6286,6205
959999,Sat,1/25/2020,8279,4158,4121
959999,Sun,1/26/2020,6604,3233,3371
959999,Mon,1/27/2020,11602,5791,5811
959999,Tue,1/28/2020,11787,5914,5873
959999,Wed,1/29/2020,11814,5930,5884
959999,Thu,1/30/2020,11948,5912,6036
959999,Fri,1/31/2020,13230,6713,6517
959999,Sat,2/1/2020,8687,4297,4390
959999,Sun,2/2/2020,7683,3796,3887
959999,Mon,2/3/2020,12162,6190,5972
959999,Tue,2/4/2020,12055,6068,5987
959999,Wed,2/5/2020,12321,6362,5959
959999,Thu,2/6/2020,12111,6245,5866
959999,Fri,2/7/2020,12571,6385,6186
959999,Sat,2/8/2020,8293,4023,4270
959999,Sun,2/9/2020,6503,3271,3232
959999,Mon,2/10/2020,11575,5820,5755
959999,Tue,2/11/2020,12189,6132,6057
959999,Wed,2/12/2020,12491,6344,6147
959999,Thu,2/13/2020,11373,5750,5623
959999,Fri,2/14/2020,11901,5960,5941
959999,Sat,2/15/2020,8058,3944,4114
959999,Sun,2/16/2020,6754,3379,3375
959999,Mon,2/17/2020,10862,5507,5355
959999,Tue,2/18/2020,11976,5992,5984
959999,Wed,2/19/2020,12005,6029,5976
959999,Thu,2/20/2020,12117,6059,6058
959999,Fri,2/21/2020,12882,6427,6455
959999,Sat,2/22/2020,8798,4353,4445
959999,Sun,2/23/2020,7435,3679,3756
959999,Mon,2/24/2020,12099,6167,5932
959999,Sat,2/29/2020,9652,4722,4930
959999,Sun,3/1/2020,7735,3808,3927
959999,Mon,3/2/2020,12473,6346,6127
959999,Tue,3/3/2020,12982,6535,6447
959999,Wed,3/4/2020,12772,6344,6428
959999,Thu,3/5/2020,12876,6384,6492
959999,Fri,3/6/2020,13663,6830,6833
959999,Sat,3/7/2020,9132,4517,4615
959999,Sun,3/8/2020,7630,3715,3915
959999,Mon,3/9/2020,11991,6070,5921
959999,Tue,3/10/2020,12299,6190,6109
959999,Wed,3/11/2020,11909,6062,5847
959999,Thu,3/12/2020,12139,6049,6090
959999,Fri,3/13/2020,12997,6508,6489
959999,Sat,3/14/2020,7981,3905,4076
959999,Sun,3/15/2020,6896,3412,3484
959999,Mon,3/16/2020,10921,5526,5395
959999,Tue,3/17/2020,10665,5381,5284
959999,Wed,3/18/2020,9874,5013,4861
959999,Thu,3/19/2020,10133,5167,4966
959999,Fri,3/20/2020,10524,5337,5187
959999,Sat,3/21/2020,6908,3405,3503
959999,Sun,3/22/2020,5424,2723,2701
959999,Mon,3/23/2020,9334,4770,4564
959999,Tue,3/24/2020,9119,4644,4475
959999,Wed,3/25/2020,8911,4526,4385
959999,Thu,3/26/2020,8419,4327,4092
959999,Fri,3/27/2020,9266,4714,4552
959999,Sat,3/28/2020,5899,2943,2956
959999,Sun,3/29/2020,4808,2364,2444
959999,Mon,3/30/2020,8728,4433,4295
959999,Tue,3/31/2020,8833,4448,4385
959999,Wed,4/1/2020,9334,4764,4570
959999,Thu,4/2/2020,9616,5024,4592
959999,Fri,4/3/2020,10055,5079,4976
959999,Sat,4/4/2020,6137,2991,3146
959999,Sun,4/5/2020,5304,2633,2671
959999,Mon,4/6/2020,9350,4760,4590
959999,Tue,4/7/2020,9770,4868,4902
959999,Wed,4/8/2020,8917,4516,4401
990101,Wed,1/1/2020,11585,5538,6047
990101,Thu,1/2/2020,19448,9298,10150
990101,Fri,1/3/2020,20775,9931,10844
990101,Sat,1/4/2020,16388,7742,8646
990101,Sun,1/5/2020,14551,6957,7594
990101,Mon,1/6/2020,19930,9559,10371
990101,Tue,1/7/2020,20581,9870,10711
990101,Wed,1/8/2020,20596,9914,10682
990101,Thu,1/9/2020,21102,10149,10953
990101,Fri,1/10/2020,22497,10772,11725
990101,Sat,1/11/2020,18159,8622,9537
990101,Sun,1/12/2020,16734,7887,8847
990101,Mon,1/13/2020,21814,10388,11426
990101,Tue,1/14/2020,21675,10300,11375
990101,Wed,1/15/2020,21501,10253,11248
990101,Thu,1/16/2020,22236,10550,11686
990101,Fri,1/17/2020,24246,11442,12804
990101,Sat,1/18/2020,17743,8394,9349
990101,Sun,1/19/2020,14739,6943,7796
990101,Mon,1/20/2020,20237,9638,10599
990101,Tue,1/21/2020,21505,10217,11288
990101,Wed,1/22/2020,21653,10289,11364
990101,Thu,1/23/2020,22238,10591,11647
990101,Fri,1/24/2020,23703,11165,12538
990101,Sat,1/25/2020,17322,8205,9117
990101,Sun,1/26/2020,16042,7622,8420
990101,Mon,1/27/2020,21207,10105,11102
990101,Tue,1/28/2020,21463,10173,11290
990101,Wed,1/29/2020,21732,10318,11414
990101,Thu,1/30/2020,22088,10466,11622
990101,Fri,1/31/2020,23884,11303,12581
990101,Sat,2/1/2020,20539,9581,10958
990101,Sun,2/2/2020,17582,8257,9325
990101,Mon,2/3/2020,21712,10300,11412
990101,Tue,2/4/2020,21851,10398,11453
990101,Wed,2/5/2020,21019,9995,11024
990101,Thu,2/6/2020,18641,8839,9802
990101,Fri,2/7/2020,24711,11856,12855
990101,Sat,2/8/2020,20912,10117,10795
990101,Sun,2/9/2020,16735,8073,8662
990101,Mon,2/10/2020,23570,11456,12114
990101,Tue,2/11/2020,24077,11646,12431
990101,Wed,2/12/2020,22944,11024,11920
990101,Thu,2/13/2020,21404,10204,11200
990101,Fri,2/14/2020,25672,12347,13325
990101,Sat,2/15/2020,20343,9707,10636
990101,Sun,2/16/2020,17996,8642,9354
990101,Mon,2/17/2020,22539,10891,11648
990101,Tue,2/18/2020,23494,11255,12239
990101,Wed,2/19/2020,23755,11401,12354
990101,Thu,2/20/2020,24151,11638,12513
990101,Fri,2/21/2020,26186,12526,13660
990101,Sat,2/22/2020,22079,10620,11459
990101,Mon,2/24/2020,22808,11082,11726
990101,Thu,2/27/2020,24182,11640,12542
990101,Fri,2/28/2020,26227,12574,13653
990101,Sat,2/29/2020,22627,10740,11887
990101,Mon,3/2/2020,23933,11529,12404
990101,Tue,3/3/2020,25000,11911,13089
990101,Wed,3/4/2020,25061,11971,13090
990101,Thu,3/5/2020,25172,12053,13119
990101,Fri,3/6/2020,26356,12651,13705
990101,Sat,3/7/2020,23621,11277,12344
990101,Sun,3/8/2020,19229,9172,10057
990101,Mon,3/9/2020,24041,11586,12455
990101,Tue,3/10/2020,24320,11602,12718
990101,Wed,3/11/2020,24773,11781,12992
990101,Thu,3/12/2020,25508,12149,13359
990101,Fri,3/13/2020,27893,13249,14644
990101,Sat,3/14/2020,17309,8211,9098
990101,Sun,3/15/2020,15603,7515,8088
990101,Mon,3/16/2020,20961,10042,10919
990101,Tue,3/17/2020,19906,9536,10370
990101,Wed,3/18/2020,18331,8748,9583
990101,Thu,3/19/2020,18428,8859,9569
990101,Fri,3/20/2020,20063,9625,10438
990101,Sat,3/21/2020,15472,7390,8082
990101,Sun,3/22/2020,11534,5637,5897
990101,Mon,3/23/2020,17757,8605,9152
990101,Wed,3/25/2020,13674,6616,7058
990101,Thu,3/26/2020,13738,6675,7063
990101,Fri,3/27/2020,14560,6932,7628
990101,Sat,3/28/2020,11926,5709,6217
990101,Sun,3/29/2020,10068,4921,5147
990101,Mon,3/30/2020,14718,7108,7610
990101,Tue,3/31/2020,14390,6939,7451
990101,Wed,4/1/2020,14528,7023,7505
990101,Thu,4/2/2020,15293,7365,7928
990101,Fri,4/3/2020,17272,8366,8906
990101,Sat,4/4/2020,13035,6243,6792
990101,Sun,4/5/2020,11128,5417,5711
990101,Mon,4/6/2020,15119,7301,7818
990101,Tue,4/7/2020,15663,7561,8102
990101,Wed,4/8/2020,15707,7695,8012
990103,Wed,1/1/2020,1407,705,702
990103,Thu,1/2/2020,2277,1161,1116
990103,Fri,1/3/2020,2605,1287,1318
990103,Sat,1/4/2020,1786,912,874
990103,Sun,1/5/2020,1711,884,827
990103,Mon,1/6/2020,2382,1193,1189
990103,Tue,1/7/2020,2402,1198,1204
990103,Wed,1/8/2020,2464,1217,1247
990103,Thu,1/9/2020,2574,1278,1296
990103,Fri,1/10/2020,2558,1256,1302
990103,Sat,1/11/2020,1794,878,916
990103,Sun,1/12/2020,1541,787,754
990103,Mon,1/13/2020,2419,1185,1234
990103,Tue,1/14/2020,2408,1224,1184
990103,Wed,1/15/2020,2457,1242,1215
990103,Thu,1/16/2020,2509,1250,1259
990103,Fri,1/17/2020,2470,1214,1256
990103,Sat,1/18/2020,1673,840,833
990103,Sun,1/19/2020,1430,725,705
990103,Mon,1/20/2020,2038,1006,1032
990103,Tue,1/21/2020,2394,1205,1189
990103,Wed,1/22/2020,2373,1194,1179
990103,Thu,1/23/2020,2429,1201,1228
990103,Fri,1/24/2020,2772,1381,1391
990103,Sat,1/25/2020,1756,873,883
990103,Sun,1/26/2020,1682,871,811
990103,Mon,1/27/2020,2330,1168,1162
990103,Tue,1/28/2020,2386,1199,1187
990103,Wed,1/29/2020,2416,1207,1209
990103,Thu,1/30/2020,2418,1211,1207
990103,Fri,1/31/2020,2611,1308,1303
990103,Sat,2/1/2020,2039,1015,1024
990103,Sun,2/2/2020,1867,969,898
990103,Mon,2/3/2020,2401,1211,1190
990103,Tue,2/4/2020,2417,1190,1227
990103,Wed,2/5/2020,2265,1140,1125
990103,Thu,2/6/2020,2001,1015,986
990103,Fri,2/7/2020,2536,1265,1271
990103,Sat,2/8/2020,1967,1014,953
990103,Sun,2/9/2020,1595,796,799
990103,Mon,2/10/2020,2343,1162,1181
990103,Tue,2/11/2020,2491,1240,1251
990103,Wed,2/12/2020,2321,1146,1175
990103,Thu,2/13/2020,2152,1066,1086
990103,Fri,2/14/2020,2603,1283,1320
990103,Sat,2/15/2020,1888,965,923
990103,Sun,2/16/2020,1715,869,846
990103,Mon,2/17/2020,2119,1045,1074
990103,Tue,2/18/2020,2448,1225,1223
990103,Wed,2/19/2020,2531,1249,1282
990103,Thu,2/20/2020,2523,1283,1240
990103,Fri,2/21/2020,2640,1317,1323
990103,Sat,2/22/2020,2062,1042,1020
990103,Sun,2/23/2020,1894,962,932
990103,Mon,2/24/2020,2327,1156,1171
990103,Thu,2/27/2020,2390,1169,1221
990103,Fri,2/28/2020,2765,1374,1391
990103,Sat,2/29/2020,2111,1042,1069
990103,Sun,3/1/2020,1870,937,933
990103,Mon,3/2/2020,2401,1192,1209
990103,Tue,3/3/2020,2611,1314,1297
990103,Wed,3/4/2020,2654,1324,1330
990103,Thu,3/5/2020,2661,1325,1336
990103,Fri,3/6/2020,2739,1349,1390
990103,Sat,3/7/2020,2220,1114,1106
990103,Sun,3/8/2020,1949,993,956
990103,Mon,3/9/2020,2404,1202,1202
990103,Tue,3/10/2020,2520,1237,1283
990103,Wed,3/11/2020,2515,1257,1258
990103,Thu,3/12/2020,2602,1288,1314
990103,Fri,3/13/2020,2816,1396,1420
990103,Sat,3/14/2020,1761,900,861
990103,Sun,3/15/2020,1690,856,834
990103,Mon,3/16/2020,2219,1120,1099
990103,Tue,3/17/2020,2264,1116,1148
990103,Wed,3/18/2020,2087,1029,1058
990103,Thu,3/19/2020,2156,1051,1105
990103,Fri,3/20/2020,2344,1142,1202
990103,Sat,3/21/2020,1685,849,836
990103,Sun,3/22/2020,1157,580,577
990103,Mon,3/23/2020,1916,968,948
990103,Tue,3/24/2020,1993,976,1017
990103,Wed,3/25/2020,1620,798,822
990103,Thu,3/26/2020,1725,853,872
990103,Fri,3/27/2020,1735,858,877
990103,Sat,3/28/2020,1272,631,641
990103,Sun,3/29/2020,1165,602,563
990103,Mon,3/30/2020,1825,913,912
990103,Tue,3/31/2020,1785,888,897
990103,Wed,4/1/2020,1890,943,947
990103,Thu,4/2/2020,1976,958,1018
990103,Fri,4/3/2020,2210,1086,1124
990103,Sat,4/4/2020,1391,694,697
990103,Sun,4/5/2020,1317,677,640
990103,Mon,4/6/2020,1918,964,954
990103,Tue,4/7/2020,1987,999,988
990103,Wed,4/8/2020,2002,1013,989
990104,Thu,1/2/2020,69962,36696,33266
990104,Fri,1/3/2020,70405,38901,31504
990104,Sun,1/5/2020,44399,20910,23489
990104,Mon,1/6/2020,63469,34479,28990
990104,Fri,1/10/2020,75178,37171,38007
990104,Sat,1/11/2020,52309,27041,25268
990104,Mon,1/13/2020,63302,33571,29731
990104,Tue,1/14/2020,66969,35426,31543
990104,Wed,1/15/2020,66270,35580,30690
990104,Thu,1/16/2020,66624,37532,29092
990104,Thu,1/23/2020,67604,36942,30662
990104,Sun,2/2/2020,48606,24871,23735
990104,Mon,2/3/2020,66635,34074,32561
990104,Tue,2/4/2020,64255,34482,29773
990104,Wed,2/12/2020,61804,34160,27644
990104,Thu,2/13/2020,59203,34846,24357
990104,Sat,2/15/2020,55706,30209,25497
990104,Sun,2/16/2020,56500,29097,27403
990104,Mon,2/17/2020,70389,37050,33339
990104,Tue,2/18/2020,66349,36624,29725
990104,Sun,2/23/2020,59708,30733,28975
990104,Mon,2/24/2020,68555,34389,34166
990104,Thu,2/27/2020,78545,39779,38766
990104,Fri,2/28/2020,87509,43806,43703
990104,Sat,2/29/2020,67200,33584,33616
990104,Sun,3/1/2020,62383,32135,30248
990104,Mon,3/2/2020,70598,35704,34894
990104,Tue,3/3/2020,74144,37066,37078
990104,Wed,3/4/2020,76090,38126,37964
990104,Thu,3/5/2020,79901,40132,39769
990104,Fri,3/6/2020,85283,44398,40885
990104,Sat,3/7/2020,63524,33468,30056
990104,Sun,3/8/2020,60277,31859,28418
990104,Mon,3/9/2020,66502,35686,30816
990104,Tue,3/10/2020,74269,37387,36882
990104,Wed,3/11/2020,76760,38662,38098
990104,Thu,3/12/2020,77702,40740,36962
990104,Fri,3/13/2020,87389,44966,42423
990104,Sat,3/14/2020,53240,26319,26921
990104,Sun,3/15/2020,51372,25591,25781
990104,Mon,3/16/2020,66112,33191,32921
990104,Tue,3/17/2020,63668,34444,29224
990104,Wed,3/18/2020,60740,32603,28137
990104,Thu,3/19/2020,60072,32083,27989
990104,Mon,3/23/2020,50801,27293,23508
990104,Wed,3/25/2020,51484,26094,25390
990104,Thu,3/26/2020,51665,26277,25388
990104,Fri,3/27/2020,49330,25242,24088
990104,Sat,3/28/2020,31413,16116,15297
990104,Sun,3/29/2020,26739,14074,12665
990104,Mon,3/30/2020,47029,23793,23236
990104,Tue,3/31/2020,48897,24807,24090
990104,Wed,4/1/2020,47178,24622,22556
990104,Thu,4/2/2020,48080,25335,22745
990104,Fri,4/3/2020,48195,25261,22934
990104,Sat,4/4/2020,30627,15789,14838
990104,Sun,4/5/2020,24861,13140,11721
990104,Mon,4/6/2020,44868,22781,22087
990104,Tue,4/7/2020,48818,24667,24151
990104,Wed,4/8/2020,48306,25063,23243
990105,Wed,1/1/2020,11752,5936,5816
990105,Thu,1/2/2020,20268,10091,10177
990105,Fri,1/3/2020,21823,10951,10872
990105,Sat,1/4/2020,17131,8698,8433
990105,Sun,1/5/2020,13124,6588,6536
990105,Mon,1/6/2020,19897,9888,10009
990105,Tue,1/7/2020,20807,10426,10381
990105,Wed,1/8/2020,21353,10739,10614
990105,Thu,1/9/2020,21167,10599,10568
990105,Fri,1/10/2020,21585,10896,10689
990105,Sat,1/11/2020,15848,7959,7889
990105,Sun,1/12/2020,13761,6899,6862
990105,Mon,1/13/2020,20797,10398,10399
990105,Tue,1/14/2020,21679,10767,10912
990105,Wed,1/15/2020,21645,10847,10798
990105,Thu,1/16/2020,22276,11193,11083
990105,Fri,1/17/2020,22455,11338,11117
990105,Sat,1/18/2020,15826,7957,7869
990105,Sun,1/19/2020,11993,5895,6098
990105,Mon,1/20/2020,19287,9595,9692
990105,Tue,1/21/2020,21226,10688,10538
990105,Wed,1/22/2020,21757,10890,10867
990105,Thu,1/23/2020,21449,10787,10662
990105,Fri,1/24/2020,22825,11480,11345
990105,Sat,1/25/2020,16959,8422,8537
990105,Sun,1/26/2020,13756,6942,6814
990105,Mon,1/27/2020,20501,10244,10257
990105,Tue,1/28/2020,20987,10506,10481
990105,Wed,1/29/2020,20983,10531,10452
990105,Thu,1/30/2020,21932,10987,10945
990105,Fri,1/31/2020,22829,11507,11322
990105,Sat,2/1/2020,17793,8894,8899
990105,Sun,2/2/2020,13670,6863,6807
990105,Mon,2/3/2020,21058,10576,10482
990105,Tue,2/4/2020,21061,10498,10563
990105,Wed,2/5/2020,20851,10426,10425
990105,Thu,2/6/2020,20900,10503,10397
990105,Fri,2/7/2020,22898,11591,11307
990105,Sat,2/8/2020,16702,8471,8231
990105,Sun,2/9/2020,12525,6123,6402
990105,Mon,2/10/2020,20692,10278,10414
990105,Tue,2/11/2020,21689,10790,10899
990105,Wed,2/12/2020,21022,10439,10583
990105,Thu,2/13/2020,21493,10755,10738
990105,Fri,2/14/2020,23294,11743,11551
990105,Sat,2/15/2020,17146,8588,8558
990105,Sun,2/16/2020,14014,7014,7000
990105,Mon,2/17/2020,20671,10333,10338
990105,Tue,2/18/2020,21518,10810,10708
990105,Wed,2/19/2020,22404,11289,11115
990105,Thu,2/20/2020,21827,10907,10920
990105,Fri,2/21/2020,23304,11711,11593
990105,Sat,2/22/2020,18354,9256,9098
990105,Sun,2/23/2020,14551,7235,7316
990105,Mon,2/24/2020,20447,10204,10243
990105,Thu,2/27/2020,22437,11218,11219
990105,Fri,2/28/2020,23932,12001,11931
990105,Sat,2/29/2020,19696,9826,9870
990105,Sun,3/1/2020,15483,7793,7690
990105,Mon,3/2/2020,21132,10603,10529
990105,Tue,3/3/2020,22417,11208,11209
990105,Wed,3/4/2020,22428,11226,11202
990105,Thu,3/5/2020,23114,11623,11491
990105,Fri,3/6/2020,24231,12256,11975
990105,Sat,3/7/2020,19054,9548,9506
990105,Sun,3/8/2020,15154,7673,7481
990105,Mon,3/9/2020,20464,10251,10213
990105,Tue,3/10/2020,21066,10543,10523
990105,Wed,3/11/2020,21710,10831,10879
990105,Thu,3/12/2020,21786,10927,10859
990105,Fri,3/13/2020,23751,11838,11913
990105,Sat,3/14/2020,15802,7885,7917
990105,Sun,3/15/2020,13014,6567,6447
990105,Mon,3/16/2020,19525,9695,9830
990105,Tue,3/17/2020,19799,9913,9886
990105,Wed,3/18/2020,18358,9210,9148
990105,Thu,3/19/2020,18022,9072,8950
990105,Fri,3/20/2020,19458,9743,9715
990105,Sat,3/21/2020,12553,6349,6204
990105,Sun,3/22/2020,8146,4162,3984
990105,Mon,3/23/2020,15049,7585,7464
990105,Tue,3/24/2020,14579,7337,7242
990105,Wed,3/25/2020,13313,6681,6632
990105,Thu,3/26/2020,13568,6847,6721
990105,Fri,3/27/2020,14069,7066,7003
990105,Sat,3/28/2020,9355,4712,4643
990105,Sun,3/29/2020,7772,3996,3776
990105,Mon,3/30/2020,13539,6801,6738
990105,Tue,3/31/2020,13442,6752,6690
990105,Wed,4/1/2020,13740,6940,6800
990105,Thu,4/2/2020,14167,7174,6993
990105,Fri,4/3/2020,15006,7444,7562
990105,Sat,4/4/2020,9394,4709,4685
990105,Sun,4/5/2020,7719,3957,3762
990105,Mon,4/6/2020,13866,6947,6919
990105,Tue,4/7/2020,14281,7131,7150
990105,Wed,4/8/2020,14405,7220,7185
990107,Wed,1/1/2020,1303,661,642
990107,Thu,1/2/2020,1604,795,809
990107,Fri,1/3/2020,1785,910,875
990107,Sat,1/4/2020,1565,784,781
990107,Sun,1/5/2020,1425,731,694
990107,Mon,1/6/2020,1689,871,818
990107,Tue,1/7/2020,1731,885,846
990107,Wed,1/8/2020,1802,917,885
990107,Thu,1/9/2020,1746,883,863
990107,Fri,1/10/2020,1677,842,835
990107,Sat,1/11/2020,1177,595,582
990107,Sun,1/12/2020,1204,629,575
990107,Mon,1/13/2020,1700,869,831
990107,Tue,1/14/2020,1678,842,836
990107,Wed,1/15/2020,1766,914,852
990107,Thu,1/16/2020,1680,858,822
990107,Fri,1/17/2020,1840,928,912
990107,Sat,1/18/2020,1376,698,678
990107,Sun,1/19/2020,1240,633,607
990107,Mon,1/20/2020,1619,844,775
990107,Tue,1/21/2020,1672,855,817
990107,Wed,1/22/2020,1779,906,873
990107,Thu,1/23/2020,1752,874,878
990107,Fri,1/24/2020,1748,889,859
990107,Sat,1/25/2020,1502,794,708
990107,Mon,1/27/2020,1644,825,819
990107,Tue,1/28/2020,1626,807,819
990107,Wed,1/29/2020,1692,874,818
990107,Thu,1/30/2020,1733,904,829
990107,Fri,1/31/2020,1793,918,875
990107,Sat,2/1/2020,1704,862,842
990107,Sun,2/2/2020,1535,763,772
990107,Mon,2/3/2020,1686,858,828
990107,Tue,2/4/2020,1672,835,837
990107,Wed,2/5/2020,1593,835,758
990107,Thu,2/6/2020,1543,789,754
990107,Fri,2/7/2020,1827,932,895
990107,Sat,2/8/2020,1513,765,748
990107,Sun,2/9/2020,1185,590,595
990107,Mon,2/10/2020,1671,852,819
990107,Tue,2/11/2020,1805,944,861
990107,Wed,2/12/2020,1664,826,838
990107,Thu,2/13/2020,1593,834,759
990107,Fri,2/14/2020,1810,916,894
990107,Sat,2/15/2020,1537,786,751
990107,Sun,2/16/2020,1472,756,716
990107,Mon,2/17/2020,1526,772,754
990107,Tue,2/18/2020,1619,826,793
990107,Wed,2/19/2020,1767,906,861
990107,Thu,2/20/2020,1749,903,846
990107,Fri,2/21/2020,1964,1012,952
990107,Sat,2/22/2020,1748,878,870
990107,Sun,2/23/2020,1496,777,719
990107,Mon,2/24/2020,1695,861,834
990107,Thu,2/27/2020,1747,904,843
990107,Fri,2/28/2020,1826,915,911
990107,Sat,2/29/2020,1749,882,867
990107,Sun,3/1/2020,1664,841,823
990107,Mon,3/2/2020,1638,834,804
990107,Tue,3/3/2020,1802,913,889
990107,Wed,3/4/2020,1828,944,884
990107,Thu,3/5/2020,1783,918,865
990107,Fri,3/6/2020,1967,989,978
990107,Sat,3/7/2020,1815,927,888
990107,Sun,3/8/2020,1785,891,894
990107,Mon,3/9/2020,1816,929,887
990107,Tue,3/10/2020,1735,894,841
990107,Wed,3/11/2020,1886,955,931
990107,Thu,3/12/2020,1835,954,881
990107,Fri,3/13/2020,2049,1047,1002
990107,Sat,3/14/2020,1602,800,802
990107,Sun,3/15/2020,1451,754,697
990107,Mon,3/16/2020,1621,836,785
990107,Tue,3/17/2020,1634,850,784
990107,Wed,3/18/2020,1482,773,709
990107,Thu,3/19/2020,1440,733,707
990107,Fri,3/20/2020,1681,873,808
990107,Sat,3/21/2020,1329,674,655
990107,Sun,3/22/2020,940,497,443
990107,Mon,3/23/2020,1340,680,660
990107,Tue,3/24/2020,1328,657,671
990107,Wed,3/25/2020,1248,640,608
990107,Thu,3/26/2020,1322,678,644
990107,Fri,3/27/2020,1336,684,652
990107,Sat,3/28/2020,1140,603,537
990107,Sun,3/29/2020,960,480,480
990107,Mon,3/30/2020,1294,639,655
990107,Tue,3/31/2020,1334,679,655
990107,Wed,4/1/2020,1416,719,697
990107,Thu,4/2/2020,1526,797,729
990107,Fri,4/3/2020,1674,840,834
990107,Sat,4/4/2020,1165,590,575
990107,Sun,4/5/2020,1002,498,504
990107,Mon,4/6/2020,1435,718,717
990107,Tue,4/7/2020,1634,824,810
990107,Wed,4/8/2020,1624,833,791
990108,Wed,1/1/2020,30791,14794,15997
990108,Thu,1/2/2020,36828,17644,19184
990108,Fri,1/3/2020,41049,21118,19931
990108,Mon,1/6/2020,31973,15473,16500
990108,Tue,1/7/2020,33446,16216,17230
990108,Wed,1/8/2020,34452,16775,17677
990108,Thu,1/9/2020,35922,17934,17988
990108,Fri,1/10/2020,39522,19508,20014
990108,Sat,1/11/2020,28116,13577,14539
990108,Sun,1/12/2020,33788,15525,18263
990108,Mon,1/13/2020,31437,14652,16785
990108,Tue,1/14/2020,33483,16359,17124
990108,Wed,1/15/2020,33715,16770,16945
990108,Thu,1/16/2020,36365,18326,18039
990108,Fri,1/17/2020,42528,22257,20271
990108,Sat,1/18/2020,26836,13695,13141
990108,Sun,1/19/2020,29138,14374,14764
990108,Mon,1/20/2020,36562,17278,19284
990108,Tue,1/21/2020,33485,16296,17189
990108,Wed,1/22/2020,33479,16553,16926
990108,Thu,1/23/2020,34068,17292,16776
990108,Fri,1/24/2020,40058,20265,19793
990108,Sat,1/25/2020,27551,13657,13894
990108,Sun,1/26/2020,32290,16192,16098
990108,Mon,1/27/2020,30670,14742,15928
990108,Tue,1/28/2020,32805,16024,16781
990108,Wed,1/29/2020,33356,16446,16910
990108,Thu,1/30/2020,36141,18094,18047
990108,Fri,1/31/2020,41027,21162,19865
990108,Sat,2/1/2020,30905,15671,15234
990108,Sun,2/2/2020,29591,14425,15166
990108,Mon,2/3/2020,31983,15077,16906
990108,Tue,2/4/2020,32917,16242,16675
990108,Wed,2/5/2020,32379,16268,16111
990108,Thu,2/6/2020,33125,16723,16402
990108,Fri,2/7/2020,40503,20591,19912
990108,Sat,2/8/2020,30505,15104,15401
990108,Sun,2/9/2020,31088,15427,15661
990108,Mon,2/10/2020,31995,15688,16307
990108,Tue,2/11/2020,33958,16695,17263
990108,Wed,2/12/2020,32922,16242,16680
990108,Thu,2/13/2020,33791,17422,16369
990108,Fri,2/14/2020,43837,22982,20855
990108,Sat,2/15/2020,33898,17158,16740
990108,Mon,2/17/2020,38703,18595,20108
990108,Tue,2/18/2020,34829,17042,17787
990108,Wed,2/19/2020,34983,17628,17355
990108,Thu,2/20/2020,38254,19327,18927
990108,Fri,2/21/2020,44365,22480,21885
990108,Sat,2/22/2020,35177,17466,17711
990108,Mon,2/24/2020,32868,15925,16943
990108,Tue,2/25/2020,32356,15959,16397
990108,Wed,2/26/2020,29996,14990,15006
990108,Fri,2/28/2020,46943,23951,22992
990108,Sat,2/29/2020,36517,18763,17754
990108,Mon,3/2/2020,34480,16876,17604
990108,Tue,3/3/2020,33985,16046,17939
990108,Wed,3/4/2020,35679,17746,17933
990108,Thu,3/5/2020,39240,19740,19500
990108,Fri,3/6/2020,47892,24384,23508
990108,Mon,3/9/2020,33893,16338,17555
990108,Tue,3/10/2020,35305,17348,17957
990108,Wed,3/11/2020,36581,18498,18083
990108,Thu,3/12/2020,41184,21393,19791
990108,Fri,3/13/2020,47848,26594,21254
990108,Sat,3/14/2020,33021,17257,15764
990108,Sun,3/15/2020,35537,17421,18116
990108,Mon,3/16/2020,33608,15961,17647
990108,Tue,3/17/2020,35875,18039,17836
990108,Wed,3/18/2020,34212,16951,17261
990108,Thu,3/19/2020,34044,17254,16790
990108,Sat,3/21/2020,29540,15046,14494
990108,Sun,3/22/2020,21365,11432,9933
990108,Mon,3/23/2020,25748,12802,12946
990108,Tue,3/24/2020,28457,14315,14142
990108,Wed,3/25/2020,27106,13664,13442
990108,Thu,3/26/2020,26537,13525,13012
990108,Fri,3/27/2020,26090,13643,12447
990108,Sat,3/28/2020,18557,9823,8734
990108,Sun,3/29/2020,16793,9011,7782
990108,Mon,3/30/2020,23332,11479,11853
990108,Tue,3/31/2020,25548,12859,12689
990108,Wed,4/1/2020,25517,12895,12622
990108,Thu,4/2/2020,25134,13102,12032
990108,Fri,4/3/2020,25205,12993,12212
990108,Sat,4/4/2020,17861,9250,8611
990108,Sun,4/5/2020,15016,7821,7195
990108,Mon,4/6/2020,21744,10709,11035
990108,Tue,4/7/2020,24667,12368,12299
990108,Wed,4/8/2020,24486,12354,12132
990201,Wed,1/1/2020,2091,1032,1059
990201,Thu,1/2/2020,4687,2348,2339
990201,Fri,1/3/2020,4865,2456,2409
990201,Sat,1/4/2020,2934,1441,1493
990201,Sun,1/5/2020,2436,1216,1220
990201,Mon,1/6/2020,5527,2826,2701
990201,Tue,1/7/2020,6016,3026,2990
990201,Wed,1/8/2020,5897,2999,2898
990201,Thu,1/9/2020,5963,3039,2924
990201,Fri,1/10/2020,5980,3002,2978
990201,Sat,1/11/2020,2969,1499,1470
990201,Sun,1/12/2020,2456,1225,1231
990201,Mon,1/13/2020,5681,2847,2834
990201,Tue,1/14/2020,6076,3042,3034
990201,Wed,1/15/2020,5931,2978,2953
990201,Thu,1/16/2020,6127,3073,3054
990201,Fri,1/17/2020,6053,3008,3045
990201,Sat,1/18/2020,2593,1304,1289
990201,Sun,1/19/2020,2337,1165,1172
990201,Mon,1/20/2020,5531,2765,2766
990201,Tue,1/21/2020,5857,2953,2904
990201,Wed,1/22/2020,6137,3107,3030
990201,Thu,1/23/2020,6132,3099,3033
990201,Fri,1/24/2020,6221,3096,3125
990201,Sat,1/25/2020,3366,1688,1678
990201,Sun,1/26/2020,2661,1329,1332
990201,Mon,1/27/2020,6050,3022,3028
990201,Tue,1/28/2020,6206,3114,3092
990201,Wed,1/29/2020,6133,3104,3029
990201,Thu,1/30/2020,6121,3053,3068
990201,Fri,1/31/2020,6526,3290,3236
990201,Sat,2/1/2020,3563,1785,1778
990201,Sun,2/2/2020,2902,1460,1442
990201,Mon,2/3/2020,6126,3070,3056
990201,Tue,2/4/2020,5871,2966,2905
990201,Wed,2/5/2020,5930,2964,2966
990201,Thu,2/6/2020,5673,2951,2722
990201,Fri,2/7/2020,6081,3063,3018
990201,Sat,2/8/2020,3633,1825,1808
990201,Sun,2/9/2020,2525,1278,1247
990201,Mon,2/10/2020,5927,3026,2901
990201,Tue,2/11/2020,6075,3041,3034
990201,Wed,2/12/2020,6233,3149,3084
990201,Thu,2/13/2020,5739,2887,2852
990201,Fri,2/14/2020,5871,2926,2945
990201,Sat,2/15/2020,3259,1628,1631
990201,Sun,2/16/2020,2845,1373,1472
990201,Mon,2/17/2020,5881,2954,2927
990201,Tue,2/18/2020,6045,3046,2999
990201,Wed,2/19/2020,6154,3092,3062
990201,Thu,2/20/2020,6216,3098,3118
990201,Fri,2/21/2020,6304,3187,3117
990201,Sat,2/22/2020,3730,1851,1879
990201,Sun,2/23/2020,3076,1526,1550
990201,Mon,2/24/2020,5975,2989,2986
990201,Tue,2/25/2020,6004,3013,2991
990201,Wed,2/26/2020,5447,2753,2694
990201,Thu,2/27/2020,5748,2916,2832
990201,Fri,2/28/2020,6428,3246,3182
990201,Sat,2/29/2020,3851,1883,1968
990201,Sun,3/1/2020,3079,1513,1566
990201,Mon,3/2/2020,6133,3119,3014
990201,Tue,3/3/2020,6359,3210,3149
990201,Wed,3/4/2020,6305,3200,3105
990201,Thu,3/5/2020,6427,3227,3200
990201,Fri,3/6/2020,6201,3115,3086
990201,Sat,3/7/2020,3590,1806,1784
990201,Sun,3/8/2020,3125,1561,1564
990201,Mon,3/9/2020,5978,3031,2947
990201,Tue,3/10/2020,6159,3098,3061
990201,Wed,3/11/2020,6289,3163,3126
990201,Thu,3/12/2020,6443,3288,3155
990201,Fri,3/13/2020,6471,3254,3217
990201,Sat,3/14/2020,3495,1751,1744
990201,Sun,3/15/2020,2863,1429,1434
990201,Mon,3/16/2020,5927,3006,2921
990201,Tue,3/17/2020,5851,2961,2890
990201,Wed,3/18/2020,5772,2906,2866
990201,Thu,3/19/2020,5885,2970,2915
990201,Fri,3/20/2020,5358,2713,2645
990201,Sat,3/21/2020,2825,1445,1380
990201,Sun,3/22/2020,2074,1038,1036
990201,Mon,3/23/2020,5624,2837,2787
990201,Tue,3/24/2020,4886,2466,2420
990201,Wed,3/25/2020,3675,1853,1822
990201,Thu,3/26/2020,3659,1853,1806
990201,Fri,3/27/2020,3698,1883,1815
990201,Sat,3/28/2020,2177,1089,1088
990201,Sun,3/29/2020,1674,810,864
990201,Mon,3/30/2020,3386,1706,1680
990201,Tue,3/31/2020,3268,1652,1616
990201,Wed,4/1/2020,3413,1710,1703
990201,Thu,4/2/2020,3906,1984,1922
990201,Fri,4/3/2020,3891,1976,1915
990201,Sat,4/4/2020,2145,1042,1103
990201,Sun,4/5/2020,2115,1062,1053
990201,Mon,4/6/2020,3859,1935,1924
990201,Tue,4/7/2020,3920,1978,1942
990201,Wed,4/8/2020,3950,1972,1978
990202,Wed,1/1/2020,2084,969,1115
990202,Thu,1/2/2020,4025,1807,2218
990202,Sat,1/4/2020,3079,1570,1509
990202,Sun,1/5/2020,2827,1675,1152
990202,Tue,1/7/2020,4935,2190,2745
990202,Wed,1/8/2020,5074,2298,2776
990202,Thu,1/9/2020,6092,3111,2981
990202,Fri,1/10/2020,5984,3082,2902
990202,Sat,1/11/2020,3645,1896,1749
990202,Sun,1/12/2020,2299,1133,1166
990202,Mon,1/13/2020,5445,2810,2635
990202,Tue,1/14/2020,5931,3047,2884
990202,Wed,1/15/2020,5774,2950,2824
990202,Thu,1/16/2020,5918,3038,2880
990202,Fri,1/17/2020,5353,2467,2886
990202,Sat,1/18/2020,2787,1441,1346
990202,Sun,1/19/2020,2206,1101,1105
990202,Mon,1/20/2020,5263,2640,2623
990202,Tue,1/21/2020,5641,2842,2799
990202,Wed,1/22/2020,5423,2491,2932
990202,Thu,1/23/2020,5401,2509,2892
990202,Fri,1/24/2020,5943,3045,2898
990202,Sat,1/25/2020,3432,1744,1688
990202,Sun,1/26/2020,2526,1246,1280
990202,Mon,1/27/2020,5610,2894,2716
990202,Tue,1/28/2020,5924,3033,2891
990202,Wed,1/29/2020,5963,3024,2939
990202,Thu,1/30/2020,5966,3082,2884
990202,Fri,1/31/2020,6457,3317,3140
990202,Sat,2/1/2020,3669,1838,1831
990202,Sun,2/2/2020,2413,1155,1258
990202,Mon,2/3/2020,5855,3013,2842
990202,Tue,2/4/2020,6187,3183,3004
990202,Wed,2/5/2020,5247,2274,2973
990202,Thu,2/6/2020,5122,2234,2888
990202,Fri,2/7/2020,5490,2426,3064
990202,Sat,2/8/2020,3163,1427,1736
990202,Sun,2/9/2020,2307,1085,1222
990202,Mon,2/10/2020,4988,2159,2829
990202,Tue,2/11/2020,5055,2206,2849
990202,Wed,2/12/2020,5250,2281,2969
990202,Thu,2/13/2020,5097,2236,2861
990202,Fri,2/14/2020,5281,2318,2963
990202,Sat,2/15/2020,3287,1526,1761
990202,Sun,2/16/2020,2349,1074,1275
990202,Mon,2/17/2020,4961,2229,2732
990202,Tue,2/18/2020,5924,3055,2869
990202,Wed,2/19/2020,5272,2323,2949
990202,Thu,2/20/2020,5870,2877,2993
990202,Fri,2/21/2020,5343,2346,2997
990202,Sat,2/22/2020,3489,1608,1881
990202,Sun,2/23/2020,2905,1468,1437
990202,Mon,2/24/2020,5940,3091,2849
990202,Tue,2/25/2020,6061,3203,2858
990202,Wed,2/26/2020,6047,3165,2882
990202,Thu,2/27/2020,6838,3570,3268
990202,Fri,2/28/2020,7058,3768,3290
990202,Sat,2/29/2020,3927,2061,1866
990202,Sun,3/1/2020,2765,1346,1419
990202,Mon,3/2/2020,5566,2717,2849
990202,Tue,3/3/2020,6938,3872,3066
990202,Wed,3/4/2020,6433,3430,3003
990202,Thu,3/5/2020,6495,3387,3108
990202,Fri,3/6/2020,7109,3869,3240
990202,Sat,3/7/2020,3972,1964,2008
990202,Sun,3/8/2020,2879,1464,1415
990202,Mon,3/9/2020,5290,2465,2825
990202,Tue,3/10/2020,6548,3503,3045
990202,Wed,3/11/2020,6385,3322,3063
990202,Thu,3/12/2020,6328,3297,3031
990202,Fri,3/13/2020,6476,3429,3047
990202,Sat,3/14/2020,3462,1739,1723
990202,Sun,3/15/2020,2374,1191,1183
990202,Mon,3/16/2020,5617,2740,2877
990202,Tue,3/17/2020,5548,2689,2859
990202,Wed,3/18/2020,4868,2184,2684
990202,Thu,3/19/2020,4891,2127,2764
990202,Fri,3/20/2020,4773,2144,2629
990202,Sat,3/21/2020,2558,1162,1396
990202,Sun,3/22/2020,1590,744,846
990202,Mon,3/23/2020,4526,1973,2553
990202,Tue,3/24/2020,4268,1844,2424
990202,Wed,3/25/2020,3487,1551,1936
990202,Thu,3/26/2020,3479,1556,1923
990202,Fri,3/27/2020,3802,1931,1871
990202,Sat,3/28/2020,1848,899,949
990202,Sun,3/29/2020,1206,602,604
990202,Mon,3/30/2020,3258,1464,1794
990202,Tue,3/31/2020,3238,1446,1792
990202,Wed,4/1/2020,3187,1411,1776
990202,Thu,4/2/2020,3465,1551,1914
990202,Fri,4/3/2020,3690,1710,1980
990202,Sat,4/4/2020,1976,950,1026
990202,Sun,4/5/2020,1521,704,817
990202,Mon,4/6/2020,3756,1712,2044
990202,Tue,4/7/2020,3855,1895,1960
990202,Wed,4/8/2020,3941,1943,1998
990203,Wed,1/1/2020,5366,2632,2734
990203,Thu,1/2/2020,10450,5197,5253
990203,Fri,1/3/2020,11486,5765,5721
990203,Sat,1/4/2020,7855,3943,3912
990203,Sun,1/5/2020,6265,3006,3259
990203,Mon,1/6/2020,11235,5654,5581
990203,Tue,1/7/2020,11773,5868,5905
990203,Wed,1/8/2020,11731,5873,5858
990203,Thu,1/9/2020,12017,5954,6063
990203,Fri,1/10/2020,12808,6392,6416
990203,Sat,1/11/2020,8183,4085,4098
990203,Sun,1/12/2020,6116,3031,3085
990203,Mon,1/13/2020,11984,5975,6009
990203,Tue,1/14/2020,11989,5992,5997
990203,Wed,1/15/2020,12026,6016,6010
990203,Thu,1/16/2020,12412,6148,6264
990203,Fri,1/17/2020,13116,6582,6534
990203,Sat,1/18/2020,6534,3292,3242
990203,Sun,1/19/2020,5349,2616,2733
990203,Mon,1/20/2020,11020,5453,5567
990203,Tue,1/21/2020,12035,5997,6038
990203,Wed,1/22/2020,12025,5985,6040
990203,Thu,1/23/2020,12099,6039,6060
990203,Fri,1/24/2020,12957,6470,6487
990203,Sat,1/25/2020,8683,4372,4311
990203,Sun,1/26/2020,6623,3278,3345
990203,Mon,1/27/2020,11559,5744,5815
990203,Tue,1/28/2020,11787,5873,5914
990203,Wed,1/29/2020,11879,5883,5996
990203,Thu,1/30/2020,12206,6108,6098
990203,Fri,1/31/2020,13429,6661,6768
990203,Sat,2/1/2020,9036,4491,4545
990203,Sun,2/2/2020,6591,3222,3369
990203,Mon,2/3/2020,12169,6058,6111
990203,Tue,2/4/2020,12163,6084,6079
990203,Wed,2/5/2020,12245,6054,6191
990203,Thu,2/6/2020,11141,5569,5572
990203,Fri,2/7/2020,13386,6669,6717
990203,Sat,2/8/2020,9309,4640,4669
990203,Sun,2/9/2020,6153,3029,3124
990203,Mon,2/10/2020,11876,5952,5924
990203,Tue,2/11/2020,12226,6070,6156
990203,Wed,2/12/2020,12123,6048,6075
990203,Thu,2/13/2020,11064,5547,5517
990203,Fri,2/14/2020,13473,6713,6760
990203,Sat,2/15/2020,8786,4389,4397
990203,Sun,2/16/2020,6658,3256,3402
990203,Mon,2/17/2020,11610,5799,5811
990203,Tue,2/18/2020,12273,6125,6148
990203,Wed,2/19/2020,12300,6206,6094
990203,Thu,2/20/2020,12557,6240,6317
990203,Fri,2/21/2020,13236,6677,6559
990203,Sat,2/22/2020,9579,4757,4822
990203,Sun,2/23/2020,7033,3502,3531
990203,Mon,2/24/2020,11783,5876,5907
990203,Tue,2/25/2020,12129,6085,6044
990203,Wed,2/26/2020,10368,5173,5195
990203,Thu,2/27/2020,12102,6032,6070
990203,Fri,2/28/2020,13889,6884,7005
990203,Sat,2/29/2020,9474,4717,4757
990203,Sun,3/1/2020,7227,3597,3630
990203,Mon,3/2/2020,12080,6045,6035
990203,Tue,3/3/2020,12561,6251,6310
990203,Wed,3/4/2020,12480,6192,6288
990203,Thu,3/5/2020,12614,6323,6291
990203,Fri,3/6/2020,13205,6611,6594
990203,Sat,3/7/2020,9673,4821,4852
990203,Sun,3/8/2020,7237,3578,3659
990203,Mon,3/9/2020,12006,6013,5993
990203,Tue,3/10/2020,12252,6143,6109
990203,Wed,3/11/2020,12635,6268,6367
990203,Thu,3/12/2020,12712,6398,6314
990203,Fri,3/13/2020,13680,6818,6862
990203,Sat,3/14/2020,8751,4445,4306
990203,Sun,3/15/2020,6146,3058,3088
990203,Mon,3/16/2020,11139,5597,5542
990203,Tue,3/17/2020,10783,5374,5409
990203,Wed,3/18/2020,10492,5297,5195
990203,Thu,3/19/2020,10566,5327,5239
990203,Fri,3/20/2020,10966,5447,5519
990203,Sat,3/21/2020,6410,3229,3181
990203,Sun,3/22/2020,4231,2129,2102
990203,Mon,3/23/2020,9543,4830,4713
990203,Tue,3/24/2020,9093,4580,4513
990203,Wed,3/25/2020,6987,3531,3456
990203,Thu,3/26/2020,7316,3754,3562
990203,Fri,3/27/2020,7695,3898,3797
990203,Sat,3/28/2020,4493,2297,2196
990203,Sun,3/29/2020,3175,1591,1584
990203,Mon,3/30/2020,7635,3801,3834
990203,Tue,3/31/2020,7669,3815,3854
990203,Wed,4/1/2020,7647,3778,3869
990203,Thu,4/2/2020,7591,3724,3867
990203,Fri,4/3/2020,7706,3863,3843
990203,Sat,4/4/2020,4839,2417,2422
990203,Sun,4/5/2020,3873,1886,1987
990203,Mon,4/6/2020,7503,3789,3714
990203,Tue,4/7/2020,7636,3812,3824
990203,Wed,4/8/2020,7574,3678,3896
990205,Wed,1/8/2020,23678,11778,11900
990205,Thu,1/9/2020,24196,12045,12151
990205,Fri,1/10/2020,25515,12718,12797
990205,Sat,1/11/2020,17759,8894,8865
990205,Sun,1/12/2020,14041,7027,7014
990205,Mon,1/13/2020,23634,11676,11958
990205,Tue,1/14/2020,25136,12387,12749
990205,Wed,1/15/2020,24987,12502,12485
990205,Fri,1/17/2020,25833,12880,12953
990205,Sat,1/18/2020,16216,8107,8109
990205,Sun,1/19/2020,12463,6272,6191
990205,Mon,1/20/2020,20018,10018,10000
990205,Tue,1/21/2020,23372,11558,11814
990205,Wed,1/22/2020,24076,12038,12038
990205,Thu,1/23/2020,24680,12325,12355
990205,Fri,1/24/2020,25035,12484,12551
990205,Sat,1/25/2020,17699,8860,8839
990205,Sun,1/26/2020,13201,6691,6510
990205,Mon,1/27/2020,22438,11167,11271
990205,Tue,1/28/2020,23766,11859,11907
990205,Wed,1/29/2020,23817,11955,11862
990205,Thu,1/30/2020,24524,12227,12297
990205,Fri,1/31/2020,26617,13196,13421
990205,Sat,2/1/2020,18963,9502,9461
990205,Sun,2/2/2020,14066,7059,7007
990205,Mon,2/3/2020,22698,11297,11401
990205,Tue,2/4/2020,23923,11930,11993
990205,Wed,2/5/2020,23657,11750,11907
990205,Thu,2/6/2020,21387,10594,10793
990205,Fri,2/7/2020,25389,12594,12795
990205,Sat,2/8/2020,18513,9302,9211
990205,Sun,2/9/2020,12495,6303,6192
990205,Mon,2/10/2020,22675,11335,11340
990205,Tue,2/11/2020,24110,11994,12116
990205,Wed,2/12/2020,23956,11988,11968
990205,Thu,2/13/2020,23183,11552,11631
990205,Fri,2/14/2020,26462,13102,13360
990205,Sat,2/15/2020,18508,9200,9308
990205,Sun,2/16/2020,14397,7243,7154
990205,Mon,2/17/2020,21573,10877,10696
990205,Tue,2/18/2020,24111,11969,12142
990205,Wed,2/19/2020,25067,12440,12627
990205,Thu,2/20/2020,24973,12481,12492
990205,Fri,2/21/2020,26241,13085,13156
990205,Sat,2/22/2020,19320,9644,9676
990205,Sun,2/23/2020,14098,7133,6965
990205,Mon,2/24/2020,22812,11345,11467
990205,Tue,2/25/2020,23808,11835,11973
990205,Wed,2/26/2020,22225,10964,11261
990205,Thu,2/27/2020,23224,11536,11688
990205,Fri,2/28/2020,26566,13177,13389
990205,Sat,2/29/2020,20907,10358,10549
990205,Sun,3/1/2020,15201,7703,7498
990205,Mon,3/2/2020,22948,11405,11543
990205,Tue,3/3/2020,25111,12472,12639
990205,Wed,3/4/2020,24876,12393,12483
990205,Thu,3/5/2020,25480,12662,12818
990205,Fri,3/6/2020,26397,13132,13265
990205,Sat,3/7/2020,20977,10528,10449
990205,Sun,3/8/2020,15411,7736,7675
990205,Mon,3/9/2020,22871,11404,11467
990205,Tue,3/10/2020,23618,11805,11813
990205,Wed,3/11/2020,24205,12090,12115
990205,Thu,3/12/2020,24255,12000,12255
990205,Fri,3/13/2020,25926,12965,12961
990205,Sat,3/14/2020,17058,8510,8548
990205,Sun,3/15/2020,12787,6431,6356
990205,Mon,3/16/2020,21023,10516,10507
990205,Tue,3/17/2020,20773,10300,10473
990205,Wed,3/18/2020,19510,9693,9817
990205,Thu,3/19/2020,19569,9658,9911
990205,Fri,3/20/2020,20858,10288,10570
990205,Sat,3/21/2020,12969,6452,6517
990205,Sun,3/22/2020,8753,4401,4352
990205,Mon,3/23/2020,17626,8792,8834
990205,Tue,3/24/2020,17338,8555,8783
990205,Wed,3/25/2020,13847,6858,6989
990205,Thu,3/26/2020,14535,7091,7444
990205,Fri,3/27/2020,15526,7641,7885
990205,Sat,3/28/2020,9254,4524,4730
990205,Sun,3/29/2020,7215,3564,3651
990205,Mon,3/30/2020,14394,7069,7325
990205,Tue,3/31/2020,15042,7364,7678
990205,Wed,4/1/2020,15226,7480,7746
990205,Thu,4/2/2020,16193,7978,8215
990205,Fri,4/3/2020,17676,8724,8952
990205,Sat,4/4/2020,11037,5452,5585
990205,Sun,4/5/2020,8528,4213,4315
990205,Mon,4/6/2020,15965,7897,8068
990205,Tue,4/7/2020,16321,8070,8251
990205,Wed,4/8/2020,16555,8146,8409
990206,Wed,1/1/2020,18055,9113,8942
990206,Thu,1/2/2020,24808,12130,12678
990206,Fri,1/3/2020,27747,13849,13898
990206,Sat,1/4/2020,24438,12061,12377
990206,Sun,1/5/2020,23394,11699,11695
990206,Mon,1/6/2020,23486,11579,11907
990206,Tue,1/7/2020,24552,11903,12649
990206,Fri,1/10/2020,28064,14173,13891
990206,Sat,1/11/2020,22579,11112,11467
990206,Sun,1/12/2020,21582,10957,10625
990206,Mon,1/13/2020,23935,11888,12047
990206,Tue,1/14/2020,25350,12505,12845
990206,Wed,1/15/2020,26512,13281,13231
990206,Thu,1/16/2020,28618,14875,13743
990206,Fri,1/17/2020,31974,16309,15665
990206,Sat,1/18/2020,19863,10046,9817
990206,Sun,1/19/2020,19709,10120,9589
990206,Mon,1/20/2020,25279,12398,12881
990206,Tue,1/21/2020,25211,12331,12880
990206,Wed,1/22/2020,26237,13198,13039
990206,Thu,1/23/2020,27186,13898,13288
990206,Fri,1/24/2020,30655,15007,15648
990206,Sat,1/25/2020,23173,11663,11510
990206,Sun,1/26/2020,23415,12671,10744
990206,Mon,1/27/2020,23763,11691,12072
990206,Tue,1/28/2020,25093,12348,12745
990206,Wed,1/29/2020,26877,13426,13451
990206,Thu,1/30/2020,27772,14016,13756
990206,Fri,1/31/2020,29963,15244,14719
990206,Sat,2/1/2020,24640,12415,12225
990206,Sun,2/2/2020,21112,11050,10062
990206,Mon,2/3/2020,24956,12236,12720
990206,Tue,2/4/2020,25621,12796,12825
990206,Wed,2/5/2020,25541,12485,13056
990206,Thu,2/6/2020,25695,13174,12521
990206,Fri,2/7/2020,30171,15491,14680
990206,Sat,2/8/2020,24567,12318,12249
990206,Sun,2/9/2020,21396,11076,10320
990206,Mon,2/10/2020,25502,12975,12527
990206,Tue,2/11/2020,26698,13092,13606
990206,Wed,2/12/2020,25925,12792,13133
990206,Thu,2/13/2020,25116,13021,12095
990206,Fri,2/14/2020,32189,16736,15453
990206,Sat,2/15/2020,26346,13574,12772
990206,Sun,2/16/2020,25101,12836,12265
990206,Mon,2/17/2020,27377,13162,14215
990206,Tue,2/18/2020,26405,13151,13254
990206,Wed,2/19/2020,27841,14032,13809
990206,Thu,2/20/2020,29133,14960,14173
990206,Fri,2/21/2020,32907,16565,16342
990206,Sat,2/22/2020,27081,13797,13284
990206,Sun,2/23/2020,25197,13451,11746
990206,Mon,2/24/2020,25413,12553,12860
990206,Tue,2/25/2020,26403,12938,13465
990206,Wed,2/26/2020,22291,11355,10936
990206,Thu,2/27/2020,28107,14455,13652
990206,Fri,2/28/2020,33712,17184,16528
990206,Sat,2/29/2020,27168,13612,13556
990206,Sun,3/1/2020,25952,13658,12294
990206,Mon,3/2/2020,25777,13097,12680
990206,Tue,3/3/2020,27401,13659,13742
990206,Wed,3/4/2020,28377,14331,14046
990206,Thu,3/5/2020,29433,15124,14309
990206,Fri,3/6/2020,33365,16849,16516
990206,Sat,3/7/2020,28285,14560,13725
990206,Sun,3/8/2020,27001,14462,12539
990206,Mon,3/9/2020,25967,13044,12923
990206,Tue,3/10/2020,26653,13459,13194
990206,Wed,3/11/2020,28238,14357,13881
990206,Thu,3/12/2020,28947,15253,13694
990206,Fri,3/13/2020,31255,16585,14670
990206,Sat,3/14/2020,21817,11668,10149
990206,Sun,3/15/2020,21428,11977,9451
990206,Mon,3/16/2020,24974,12882,12092
990206,Tue,3/17/2020,24973,13026,11947
990206,Wed,3/18/2020,24191,12919,11272
990206,Thu,3/19/2020,23904,13181,10723
990206,Fri,3/20/2020,24382,13421,10961
990206,Sat,3/21/2020,16867,9459,7408
990206,Sun,3/22/2020,14018,7977,6041
990206,Mon,3/23/2020,18498,9758,8740
990206,Tue,3/24/2020,18498,9535,8963
990206,Wed,3/25/2020,16370,8821,7549
990206,Thu,3/26/2020,16119,8864,7255
990206,Fri,3/27/2020,15499,8381,7118
990206,Sat,3/28/2020,9966,5399,4567
990206,Sun,3/29/2020,9093,4914,4179
990206,Mon,3/30/2020,14271,7309,6962
990206,Tue,3/31/2020,14713,7490,7223
990206,Wed,4/1/2020,15137,7931,7206
990206,Thu,4/2/2020,14971,8045,6926
990206,Fri,4/3/2020,14852,7932,6920
990206,Sat,4/4/2020,10036,5228,4808
990206,Sun,4/5/2020,9033,4778,4255
990206,Mon,4/6/2020,13456,6776,6680
990206,Tue,4/7/2020,13831,6957,6874
990206,Wed,4/8/2020,14275,7409,6866
990207,Wed,1/1/2020,1948,922,1026
990207,Thu,1/2/2020,1436,661,775
990207,Fri,1/3/2020,1160,561,599
990207,Sat,1/4/2020,2027,923,1104
990207,Sun,1/5/2020,2050,913,1137
990207,Mon,1/6/2020,2087,938,1149
990207,Fri,1/10/2020,2174,961,1213
990207,Sat,1/11/2020,1354,621,733
990207,Sun,1/12/2020,1243,562,681
990207,Tue,1/14/2020,2136,970,1166
990207,Wed,1/15/2020,1894,876,1018
990207,Thu,1/16/2020,1989,902,1087
990207,Fri,1/17/2020,2160,935,1225
990207,Sat,1/18/2020,1305,580,725
990207,Sun,1/19/2020,1070,521,549
990207,Mon,1/20/2020,1718,792,926
990207,Tue,1/21/2020,1912,887,1025
990207,Wed,1/22/2020,2085,938,1147
990207,Thu,1/23/2020,2086,956,1130
990207,Sat,1/25/2020,869,461,408
990207,Sun,1/26/2020,871,456,415
990207,Mon,1/27/2020,1209,613,596
990207,Wed,1/29/2020,1157,572,585
990207,Thu,1/30/2020,1158,582,576
990207,Fri,1/31/2020,1357,640,717
990207,Sat,2/1/2020,952,484,468
990207,Sun,2/2/2020,814,377,437
990207,Tue,2/4/2020,1263,631,632
990207,Wed,2/5/2020,1193,554,639
990207,Thu,2/6/2020,1144,534,610
990207,Fri,2/7/2020,1358,666,692
990207,Sat,2/8/2020,1037,504,533
990207,Sun,2/9/2020,848,434,414
990207,Mon,2/10/2020,1199,578,621
990207,Tue,2/11/2020,1190,608,582
990207,Wed,2/12/2020,1205,605,600
990207,Thu,2/13/2020,1119,542,577
990207,Fri,2/14/2020,1331,632,699
990207,Sat,2/15/2020,969,489,480
990207,Mon,2/24/2020,1231,568,663
990207,Tue,3/17/2020,1174,573,601
990208,Wed,1/1/2020,423,214,209
990208,Thu,1/2/2020,777,391,386
990208,Fri,1/3/2020,880,428,452
990208,Sat,1/4/2020,554,279,275
990208,Sun,1/5/2020,451,231,220
990208,Mon,1/6/2020,793,380,413
990208,Tue,1/7/2020,846,412,434
990208,Wed,1/8/2020,784,374,410
990208,Thu,1/9/2020,813,413,400
990208,Fri,1/10/2020,813,407,406
990208,Sat,1/11/2020,482,257,225
990208,Sun,1/12/2020,416,196,220
990208,Mon,1/13/2020,795,395,400
990208,Tue,1/14/2020,830,393,437
990208,Wed,1/15/2020,828,391,437
990208,Thu,1/16/2020,831,390,441
990208,Fri,1/17/2020,815,387,428
990208,Sat,1/18/2020,398,203,195
990208,Sun,1/19/2020,376,189,187
990208,Mon,1/20/2020,737,366,371
990208,Tue,1/21/2020,803,389,414
990208,Wed,1/22/2020,806,371,435
990208,Thu,1/23/2020,855,407,448
990208,Fri,1/24/2020,792,384,408
990208,Sat,1/25/2020,538,271,267
990208,Sun,1/26/2020,433,220,213
990208,Mon,1/27/2020,789,395,394
990208,Tue,1/28/2020,785,381,404
990208,Wed,1/29/2020,867,422,445
990208,Thu,1/30/2020,839,404,435
990208,Fri,1/31/2020,809,385,424
990208,Sat,2/1/2020,571,280,291
990208,Sun,2/2/2020,452,226,226
990208,Mon,2/3/2020,800,381,419
990208,Tue,2/4/2020,858,420,438
990208,Wed,2/5/2020,775,365,410
990208,Thu,2/6/2020,690,335,355
990208,Fri,2/7/2020,729,359,370
990208,Sat,2/8/2020,494,231,263
990208,Sun,2/9/2020,366,177,189
990208,Mon,2/10/2020,737,349,388
990208,Tue,2/11/2020,834,400,434
990208,Wed,2/12/2020,863,410,453
990208,Thu,2/13/2020,681,335,346
990208,Fri,2/14/2020,773,387,386
990208,Sat,2/15/2020,590,281,309
990208,Sun,2/16/2020,446,223,223
990208,Mon,2/17/2020,771,366,405
990208,Tue,2/18/2020,790,378,412
990208,Wed,2/19/2020,918,426,492
990208,Thu,2/20/2020,849,412,437
990208,Fri,2/21/2020,832,395,437
990208,Sat,2/22/2020,629,296,333
990208,Sun,2/23/2020,446,204,242
990208,Mon,2/24/2020,803,404,399
990208,Tue,2/25/2020,841,404,437
990208,Wed,2/26/2020,629,320,309
990208,Thu,2/27/2020,705,342,363
990208,Fri,2/28/2020,828,408,420
990208,Sat,2/29/2020,553,261,292
990208,Sun,3/1/2020,531,262,269
990208,Mon,3/2/2020,826,390,436
990208,Tue,3/3/2020,996,489,507
990208,Wed,3/4/2020,954,458,496
990208,Thu,3/5/2020,920,445,475
990208,Fri,3/6/2020,885,435,450
990208,Mon,3/9/2020,934,437,497
990208,Tue,3/10/2020,898,430,468
990208,Wed,3/11/2020,910,426,484
990208,Thu,3/12/2020,875,445,430
990208,Fri,3/13/2020,962,480,482
990208,Sat,3/14/2020,587,286,301
990208,Sun,3/15/2020,457,231,226
990208,Mon,3/16/2020,778,379,399
990208,Tue,3/17/2020,796,388,408
990208,Wed,3/18/2020,763,373,390
990208,Thu,3/19/2020,704,356,348
990208,Fri,3/20/2020,758,362,396
990208,Sat,3/21/2020,509,259,250
990208,Sun,3/22/2020,380,185,195
990208,Mon,3/23/2020,657,310,347
990208,Tue,3/24/2020,613,290,323
990208,Wed,3/25/2020,493,246,247
990208,Thu,3/26/2020,565,284,281
990208,Fri,3/27/2020,526,267,259
990208,Sat,3/28/2020,325,164,161
990208,Sun,3/29/2020,250,127,123
990208,Mon,3/30/2020,494,240,254
990208,Tue,3/31/2020,477,232,245
990208,Wed,4/1/2020,554,278,276
990208,Thu,4/2/2020,532,265,267
990208,Fri,4/3/2020,651,326,325
990208,Sat,4/4/2020,430,220,210
990208,Sun,4/5/2020,327,175,152
990208,Mon,4/6/2020,405,172,233
990208,Tue,4/7/2020,345,154,191
990208,Wed,4/8/2020,367,160,207
990271,Wed,1/1/2020,26013,12574,13439
990271,Thu,1/2/2020,52443,25804,26639
990271,Fri,1/3/2020,55729,27868,27861
990271,Sat,1/4/2020,39813,20153,19660
990271,Sun,1/5/2020,32656,16242,16414
990271,Mon,1/6/2020,53259,26019,27240
990271,Tue,1/7/2020,55039,26959,28080
990271,Wed,1/8/2020,54821,27110,27711
990271,Thu,1/9/2020,56972,28398,28574
990271,Fri,1/10/2020,57434,28736,28698
990271,Sat,1/11/2020,38744,19197,19547
990271,Sun,1/12/2020,31841,16050,15791
990271,Mon,1/13/2020,53673,26389,27284
990271,Tue,1/14/2020,56409,27901,28508
990271,Wed,1/15/2020,57310,28541,28769
990271,Thu,1/16/2020,59124,29582,29542
990271,Fri,1/17/2020,58774,29258,29516
990271,Sat,1/18/2020,32441,16584,15857
990271,Sun,1/19/2020,28852,14493,14359
990271,Mon,1/20/2020,50197,24495,25702
990271,Tue,1/21/2020,54582,26787,27795
990271,Wed,1/22/2020,55412,27544,27868
990271,Thu,1/23/2020,56769,28266,28503
990271,Fri,1/24/2020,57190,28322,28868
990271,Sat,1/25/2020,38300,19373,18927
990271,Sun,1/26/2020,32968,16771,16197
990271,Mon,1/27/2020,52117,25508,26609
990271,Tue,1/28/2020,54464,26867,27597
990271,Wed,1/29/2020,55304,27509,27795
990271,Thu,1/30/2020,57784,28570,29214
990271,Fri,1/31/2020,59694,29644,30050
990271,Sat,2/1/2020,40890,20653,20237
990271,Sun,2/2/2020,31438,15844,15594
990271,Mon,2/3/2020,53275,26101,27174
990271,Tue,2/4/2020,55116,27477,27639
990271,Wed,2/5/2020,53596,26397,27199
990271,Thu,2/6/2020,50063,25042,25021
990271,Fri,2/7/2020,57529,28751,28778
990271,Sat,2/8/2020,40454,20339,20115
990271,Sun,2/9/2020,29625,14675,14950
990271,Mon,2/10/2020,54030,26967,27063
990271,Tue,2/11/2020,56789,28000,28789
990271,Wed,2/12/2020,53334,26029,27305
990271,Thu,2/13/2020,51472,25725,25747
990271,Fri,2/14/2020,59504,30156,29348
990271,Sat,2/15/2020,42854,21604,21250
990271,Thu,2/20/2020,57858,28731,29127
990271,Fri,2/21/2020,60967,30380,30587
990271,Sat,2/22/2020,43850,21955,21895
990271,Sun,2/23/2020,34277,17468,16809
990271,Mon,2/24/2020,53481,26397,27084
990271,Tue,2/25/2020,55362,27287,28075
990271,Wed,2/26/2020,45490,22720,22770
990271,Thu,2/27/2020,54871,27220,27651
990271,Fri,2/28/2020,61801,30763,31038
990271,Sat,2/29/2020,44927,22594,22333
990271,Sun,3/1/2020,35584,17964,17620
990271,Mon,3/2/2020,54334,27096,27238
990271,Tue,3/3/2020,56323,27914,28409
990271,Wed,3/4/2020,57909,28840,29069
990271,Thu,3/5/2020,59527,29659,29868
990271,Fri,3/6/2020,61202,30316,30886
990271,Sat,3/7/2020,46235,23374,22861
990271,Sun,3/8/2020,35963,18624,17339
990271,Mon,3/9/2020,54421,27262,27159
990271,Tue,3/10/2020,55461,27562,27899
990271,Wed,3/11/2020,56274,28029,28245
990271,Thu,3/12/2020,57278,28945,28333
990271,Fri,3/13/2020,57781,29323,28458
990271,Sat,3/14/2020,34783,17998,16785
990271,Sun,3/15/2020,28586,15324,13262
990271,Mon,3/16/2020,49197,24819,24378
990271,Tue,3/17/2020,47667,24113,23554
990271,Wed,3/18/2020,45743,23410,22333
990271,Thu,3/19/2020,44430,22863,21567
990271,Fri,3/20/2020,44593,23149,21444
990271,Sat,3/21/2020,24615,13084,11531
990271,Sun,3/22/2020,18425,9914,8511
990271,Mon,3/23/2020,36755,18570,18185
990271,Tue,3/24/2020,35962,18063,17899
990271,Wed,3/25/2020,29502,15021,14481
990271,Thu,3/26/2020,29992,15449,14543
990271,Fri,3/27/2020,29582,15094,14488
990271,Sat,3/28/2020,15062,7919,7143
990271,Sun,3/29/2020,12664,6599,6065
990271,Mon,3/30/2020,28631,14292,14339
990271,Tue,3/31/2020,29398,14725,14673
990271,Wed,4/1/2020,29156,14697,14459
990271,Thu,4/2/2020,29641,15012,14629
990271,Fri,4/3/2020,30230,15377,14853
990271,Sat,4/4/2020,17259,8839,8420
990271,Sun,4/5/2020,13885,7140,6745
990271,Mon,4/6/2020,29029,14553,14476
990271,Tue,4/7/2020,29338,14593,14745
990271,Wed,4/8/2020,29983,15011,14972
990311,Wed,1/1/2020,41731,21273,20458
990311,Thu,1/2/2020,71921,35818,36103
990311,Fri,1/3/2020,74505,37344,37161
990311,Sat,1/4/2020,51925,26413,25512
990311,Sun,1/5/2020,45620,22031,23589
990311,Mon,1/6/2020,72289,36431,35858
990311,Tue,1/7/2020,73533,37401,36132
990311,Wed,1/8/2020,77426,38895,38531
990311,Thu,1/9/2020,77571,38858,38713
990311,Fri,1/10/2020,71457,37041,34416
990311,Sat,1/11/2020,42724,19367,23357
990311,Sun,1/12/2020,45209,21436,23773
990311,Mon,1/13/2020,75132,37225,37907
990311,Tue,1/14/2020,76587,38325,38262
990311,Thu,1/16/2020,78642,39267,39375
990311,Fri,1/17/2020,82977,41483,41494
990311,Sat,1/18/2020,46586,22323,24263
990311,Sun,1/19/2020,42538,20764,21774
990311,Mon,1/20/2020,65852,32179,33673
990311,Tue,1/21/2020,76995,38067,38928
990311,Wed,1/22/2020,77768,39221,38547
990311,Thu,1/23/2020,78610,39375,39235
990311,Fri,1/24/2020,79963,39731,40232
990311,Sat,1/25/2020,49877,23960,25917
990311,Sun,1/26/2020,46192,22558,23634
990311,Mon,1/27/2020,73480,36645,36835
990311,Tue,1/28/2020,75142,37527,37615
990311,Wed,1/29/2020,78241,39046,39195
990311,Thu,1/30/2020,77568,39609,37959
990311,Fri,1/31/2020,80891,40709,40182
990311,Sat,2/1/2020,52372,25572,26800
990311,Sun,2/2/2020,44834,22195,22639
990311,Mon,2/3/2020,75343,37566,37777
990311,Tue,2/4/2020,74687,37521,37166
990311,Wed,2/5/2020,73534,36688,36846
990311,Thu,2/6/2020,73003,36488,36515
990311,Fri,2/7/2020,81149,39885,41264
990311,Sat,2/8/2020,53580,25632,27948
990311,Sun,2/9/2020,42960,20787,22173
990311,Mon,2/10/2020,75226,37328,37898
990311,Tue,2/11/2020,79007,39148,39859
990311,Wed,2/12/2020,74646,37044,37602
990311,Thu,2/13/2020,73671,37061,36610
990311,Fri,2/14/2020,82186,40379,41807
990311,Sat,2/15/2020,52315,24752,27563
990311,Sun,2/16/2020,47228,22652,24576
990311,Thu,2/20/2020,81187,40772,40415
990311,Fri,2/21/2020,84469,41410,43059
990311,Sat,2/22/2020,54991,26157,28834
990311,Sun,2/23/2020,49709,24387,25322
990311,Mon,2/24/2020,73013,36746,36267
990311,Tue,2/25/2020,77101,38871,38230
990311,Wed,2/26/2020,73309,37263,36046
990311,Thu,2/27/2020,81735,40622,41113
990311,Fri,2/28/2020,83132,40667,42465
990311,Sun,3/1/2020,51925,25785,26140
990311,Mon,3/2/2020,74966,38005,36961
990311,Tue,3/3/2020,78220,39105,39115
990311,Wed,3/4/2020,81952,41153,40799
990311,Thu,3/5/2020,82599,41477,41122
990311,Fri,3/6/2020,84719,42248,42471
990311,Sat,3/7/2020,56912,27347,29565
990311,Sun,3/8/2020,50788,25176,25612
990311,Mon,3/9/2020,74971,37535,37436
990311,Tue,3/10/2020,77593,38735,38858
990311,Wed,3/11/2020,78125,39275,38850
990311,Thu,3/12/2020,76865,38593,38272
990311,Fri,3/13/2020,77891,38613,39278
990311,Sat,3/14/2020,43104,20438,22666
990311,Sun,3/15/2020,41753,19952,21801
990311,Mon,3/16/2020,62032,30756,31276
990311,Tue,3/17/2020,60500,30122,30378
990311,Wed,3/18/2020,55262,27088,28174
990311,Thu,3/19/2020,53203,26646,26557
990311,Fri,3/20/2020,57188,27954,29234
990311,Sat,3/21/2020,37572,18429,19143
990311,Sun,3/22/2020,27507,14361,13146
990311,Mon,3/23/2020,47530,23754,23776
990311,Tue,3/24/2020,47665,23742,23923
990311,Wed,3/25/2020,41961,20719,21242
990311,Thu,3/26/2020,42294,21113,21181
990311,Fri,3/27/2020,41515,20655,20860
990311,Sat,3/28/2020,26977,13325,13652
990311,Sun,3/29/2020,23334,11735,11599
990311,Mon,3/30/2020,39626,19517,20109
990311,Tue,3/31/2020,40111,19859,20252
990311,Wed,4/1/2020,40467,19979,20488
990311,Thu,4/2/2020,40729,20210,20519
990311,Fri,4/3/2020,42301,20928,21373
990311,Mon,4/6/2020,38771,19107,19664
990311,Wed,4/8/2020,41086,20280,20806
990312,Wed,1/1/2020,62951,37598,25353
990312,Thu,1/2/2020,95436,56219,39217
990312,Fri,1/3/2020,101402,59049,42353
990312,Sat,1/4/2020,80829,47604,33225
990312,Sun,1/5/2020,68891,40190,28701
990312,Tue,1/7/2020,100865,58974,41891
990312,Thu,1/9/2020,100223,58569,41654
990312,Fri,1/10/2020,99817,57812,42005
990312,Sat,1/11/2020,81344,47582,33762
990312,Sun,1/12/2020,70172,41461,28711
990312,Tue,1/14/2020,101194,59168,42026
990312,Wed,1/15/2020,102394,59927,42467
990312,Thu,1/16/2020,103846,60775,43071
990312,Fri,1/17/2020,108214,62974,45240
990312,Sat,1/18/2020,78102,46192,31910
990312,Sun,1/19/2020,64124,37946,26178
990312,Tue,1/21/2020,101373,59330,42043
990312,Wed,1/22/2020,99022,56839,42183
990312,Thu,1/23/2020,104773,61148,43625
990312,Fri,1/24/2020,104578,60979,43599
990312,Sat,1/25/2020,82318,48828,33490
990312,Sun,1/26/2020,70799,41800,28999
990312,Tue,1/28/2020,100049,57627,42422
990312,Wed,1/29/2020,103863,60829,43034
990312,Thu,1/30/2020,104783,61263,43520
990312,Fri,1/31/2020,110074,64167,45907
990312,Sat,2/1/2020,87178,51446,35732
990312,Sun,2/2/2020,69316,40918,28398
990312,Mon,2/3/2020,100768,59568,41200
990312,Tue,2/4/2020,99905,58225,41680
990312,Wed,2/5/2020,97406,57271,40135
990312,Thu,2/6/2020,100168,58413,41755
990312,Fri,2/7/2020,108274,62895,45379
990312,Sat,2/8/2020,87702,51873,35829
990312,Sun,2/9/2020,66079,39299,26780
990312,Mon,2/10/2020,99378,58144,41234
990312,Tue,2/11/2020,104914,61851,43063
990312,Wed,2/12/2020,97551,57452,40099
990312,Thu,2/13/2020,96630,55106,41524
990312,Fri,2/14/2020,109501,63083,46418
990312,Sat,2/15/2020,89468,52514,36954
990312,Sun,2/16/2020,73599,43151,30448
990312,Mon,2/17/2020,98760,57945,40815
990312,Tue,2/18/2020,104114,60896,43218
990312,Wed,2/19/2020,105683,61821,43862
990312,Thu,2/20/2020,107076,62107,44969
990312,Fri,2/21/2020,113371,65740,47631
990312,Sun,2/23/2020,75807,44544,31263
990312,Mon,2/24/2020,97310,57132,40178
990312,Tue,2/25/2020,102396,59383,43013
990312,Wed,2/26/2020,97792,57028,40764
990312,Thu,2/27/2020,106425,62270,44155
990312,Fri,2/28/2020,112732,64974,47758
990312,Sun,3/1/2020,78901,45922,32979
990312,Mon,3/2/2020,100389,58441,41948
990312,Tue,3/3/2020,107639,62184,45455
990312,Wed,3/4/2020,108429,62781,45648
990312,Thu,3/5/2020,108650,62925,45725
990312,Fri,3/6/2020,114270,65923,48347
990312,Sat,3/7/2020,97261,56955,40306
990312,Sun,3/8/2020,77207,44525,32682
990312,Mon,3/9/2020,99839,58584,41255
990312,Tue,3/10/2020,104167,60893,43274
990312,Wed,3/11/2020,106120,61994,44126
990312,Thu,3/12/2020,103365,60689,42676
990312,Fri,3/13/2020,107346,62464,44882
990312,Sat,3/14/2020,70514,41870,28644
990312,Sun,3/15/2020,62582,36566,26016
990312,Mon,3/16/2020,91382,53832,37550
990312,Tue,3/17/2020,87812,51652,36160
990312,Wed,3/18/2020,82694,48753,33941
990312,Thu,3/19/2020,80426,47297,33129
990312,Fri,3/20/2020,83815,49184,34631
990312,Sat,3/21/2020,57025,33202,23823
990312,Sun,3/22/2020,42009,24291,17718
990312,Mon,3/23/2020,74617,44124,30493
990312,Tue,3/24/2020,74545,44063,30482
990312,Wed,3/25/2020,66938,39598,27340
990312,Thu,3/26/2020,66518,39088,27430
990312,Fri,3/27/2020,65120,38762,26358
990312,Sat,3/28/2020,41989,24784,17205
990312,Sun,3/29/2020,35495,20635,14860
990312,Mon,3/30/2020,65281,38680,26601
990312,Tue,3/31/2020,65764,39002,26762
990312,Wed,4/1/2020,66160,39008,27152
990312,Thu,4/2/2020,68019,40050,27969
990312,Fri,4/3/2020,70350,41256,29094
990312,Sat,4/4/2020,45089,26293,18796
990312,Sun,4/5/2020,36194,20897,15297
990312,Mon,4/6/2020,65062,38534,26528
990312,Tue,4/7/2020,67636,39959,27677
990327,Wed,1/1/2020,27017,13908,13109
990327,Thu,1/2/2020,38704,18954,19750
990327,Fri,1/3/2020,42713,21232,21481
990327,Sat,1/4/2020,35537,17931,17606
990327,Sun,1/5/2020,36927,20249,16678
990327,Mon,1/6/2020,38277,18757,19520
990327,Tue,1/7/2020,39714,19247,20467
990327,Wed,1/8/2020,41196,20292,20904
990327,Thu,1/9/2020,41785,20966,20819
990327,Fri,1/10/2020,43678,21472,22206
990327,Sat,1/11/2020,34193,16659,17534
990327,Sun,1/12/2020,32267,16361,15906
990327,Mon,1/13/2020,38850,19187,19663
990327,Tue,1/14/2020,40208,19724,20484
990327,Wed,1/15/2020,41734,20694,21040
990327,Thu,1/16/2020,43837,22201,21636
990327,Fri,1/17/2020,48585,23578,25007
990327,Sat,1/18/2020,32042,16090,15952
990327,Sun,1/19/2020,29456,15163,14293
990327,Mon,1/20/2020,40617,20281,20336
990327,Tue,1/21/2020,40602,19794,20808
990327,Wed,1/22/2020,41819,20787,21032
990327,Thu,1/23/2020,42386,21252,21134
990327,Sat,1/25/2020,35840,17886,17954
990327,Sun,1/26/2020,34305,18496,15809
990327,Mon,1/27/2020,38430,18843,19587
990327,Tue,1/28/2020,40180,19603,20577
990327,Wed,1/29/2020,42429,20802,21627
990327,Thu,1/30/2020,43311,21530,21781
990327,Fri,1/31/2020,46962,22965,23997
990327,Sat,2/1/2020,38453,19336,19117
990327,Sun,2/2/2020,31874,16700,15174
990327,Mon,2/3/2020,40458,19943,20515
990327,Tue,2/4/2020,39742,19459,20283
990327,Wed,2/5/2020,37790,19154,18636
990327,Thu,2/6/2020,38224,19238,18986
990327,Fri,2/7/2020,47144,22928,24216
990327,Sat,2/8/2020,39316,19352,19964
990327,Sun,2/9/2020,33455,17549,15906
990327,Mon,2/10/2020,40434,20570,19864
990327,Tue,2/11/2020,42578,20702,21876
990327,Wed,2/12/2020,41060,20087,20973
990327,Thu,2/13/2020,39491,19867,19624
990327,Fri,2/14/2020,48589,23864,24725
990327,Sat,2/15/2020,39543,19925,19618
990327,Sun,2/16/2020,36291,18993,17298
990327,Mon,2/17/2020,42831,20834,21997
990327,Tue,2/18/2020,42347,20819,21528
990327,Wed,2/19/2020,43727,21649,22078
990327,Thu,2/20/2020,45048,22631,22417
990327,Fri,2/21/2020,51334,24910,26424
990327,Sat,2/22/2020,43747,22032,21715
990327,Sun,2/23/2020,37981,20167,17814
990327,Mon,2/24/2020,40622,20022,20600
990327,Tue,2/25/2020,42322,20650,21672
990327,Wed,2/26/2020,36697,18372,18325
990327,Thu,2/27/2020,43677,21767,21910
990327,Fri,2/28/2020,53117,24991,28126
990327,Sat,2/29/2020,42011,20377,21634
990327,Sun,3/1/2020,36508,18913,17595
990327,Mon,3/2/2020,40022,20062,19960
990327,Tue,3/3/2020,42538,20895,21643
990327,Wed,3/4/2020,43966,21755,22211
990327,Thu,3/5/2020,45253,22818,22435
990327,Fri,3/6/2020,49157,24210,24947
990327,Sat,3/7/2020,42298,21601,20697
990327,Sun,3/8/2020,40380,22912,17468
990327,Mon,3/9/2020,41476,20963,20513
990327,Tue,3/10/2020,42201,20826,21375
990327,Wed,3/11/2020,44328,21924,22404
990327,Thu,3/12/2020,44259,22438,21821
990327,Fri,3/13/2020,47071,23878,23193
990327,Sat,3/14/2020,31403,16270,15133
990327,Sun,3/15/2020,30796,16415,14381
990327,Mon,3/16/2020,37788,18994,18794
990327,Tue,3/17/2020,37799,18952,18847
990327,Wed,3/18/2020,35592,18015,17577
990327,Thu,3/19/2020,35003,18283,16720
990327,Fri,3/20/2020,35798,18619,17179
990327,Sat,3/21/2020,24343,12896,11447
990327,Sun,3/22/2020,19781,10650,9131
990327,Mon,3/23/2020,28888,14751,14137
990327,Tue,3/24/2020,28452,14239,14213
990327,Wed,3/25/2020,25134,12956,12178
990327,Thu,3/26/2020,24788,13047,11741
990327,Fri,3/27/2020,24018,12488,11530
990327,Sat,3/28/2020,14689,7664,7025
990327,Sun,3/29/2020,13587,7152,6435
990327,Mon,3/30/2020,23055,11542,11513
990327,Tue,3/31/2020,23760,11904,11856
990327,Wed,4/1/2020,24284,12438,11846
990327,Thu,4/2/2020,24272,12541,11731
990327,Fri,4/3/2020,24322,12426,11896
990327,Sat,4/4/2020,15735,8056,7679
990327,Sun,4/5/2020,13221,6877,6344
990327,Mon,4/6/2020,22673,11340,11333
990327,Tue,4/7/2020,22945,11398,11547
990327,Wed,4/8/2020,23769,12037,11732
990328,Wed,1/1/2020,3028,1543,1485
990328,Thu,1/2/2020,4737,2319,2418
990328,Fri,1/3/2020,5287,2658,2629
990328,Sat,1/4/2020,3711,1828,1883
990328,Sun,1/5/2020,3405,1715,1690
990328,Mon,1/6/2020,4892,2416,2476
990328,Tue,1/7/2020,5047,2504,2543
990328,Wed,1/8/2020,5276,2650,2626
990328,Thu,1/9/2020,5202,2560,2642
990328,Fri,1/10/2020,5245,2607,2638
990328,Sat,1/11/2020,3670,1831,1839
990328,Sun,1/12/2020,3208,1619,1589
990328,Mon,1/13/2020,4889,2413,2476
990328,Tue,1/14/2020,5215,2636,2579
990328,Wed,1/15/2020,5249,2627,2622
990328,Thu,1/16/2020,5305,2633,2672
990328,Fri,1/17/2020,5348,2680,2668
990328,Sat,1/18/2020,3717,1873,1844
990328,Sun,1/19/2020,3141,1595,1546
990328,Mon,1/20/2020,4514,2232,2282
990328,Tue,1/21/2020,4915,2431,2484
990328,Wed,1/22/2020,5120,2566,2554
990328,Thu,1/23/2020,5204,2572,2632
990328,Fri,1/24/2020,5353,2653,2700
990328,Sat,1/25/2020,3961,2006,1955
990328,Sun,1/26/2020,3242,1643,1599
990328,Mon,1/27/2020,4743,2342,2401
990328,Tue,1/28/2020,4894,2456,2438
990328,Wed,1/29/2020,4999,2481,2518
990328,Thu,1/30/2020,5042,2525,2517
990328,Fri,1/31/2020,5330,2679,2651
990328,Sat,2/1/2020,4185,2062,2123
990328,Sun,2/2/2020,3229,1662,1567
990328,Mon,2/3/2020,4928,2436,2492
990328,Tue,2/4/2020,4857,2425,2432
990328,Wed,2/5/2020,4800,2423,2377
990328,Thu,2/6/2020,4874,2470,2404
990328,Fri,2/7/2020,5373,2686,2687
990328,Sat,2/8/2020,4189,2096,2093
990328,Sun,2/9/2020,3067,1532,1535
990328,Mon,2/10/2020,4722,2355,2367
990328,Tue,2/11/2020,5286,2640,2646
990328,Wed,2/12/2020,4866,2448,2418
990328,Thu,2/13/2020,4493,2245,2248
990328,Fri,2/14/2020,5515,2760,2755
990328,Sat,2/15/2020,4295,2160,2135
990328,Sun,2/16/2020,3283,1686,1597
990328,Mon,2/17/2020,4667,2295,2372
990328,Tue,2/18/2020,5059,2533,2526
990328,Wed,2/19/2020,5249,2627,2622
990328,Thu,2/20/2020,5488,2738,2750
990328,Fri,2/21/2020,6016,3041,2975
990328,Sat,2/22/2020,4515,2251,2264
990328,Sun,2/23/2020,3338,1709,1629
990328,Mon,2/24/2020,4806,2358,2448
990328,Tue,2/25/2020,5116,2562,2554
990328,Wed,2/26/2020,4960,2467,2493
990328,Thu,2/27/2020,5051,2537,2514
990328,Fri,2/28/2020,5855,2930,2925
990328,Sat,2/29/2020,4633,2292,2341
990328,Sun,3/1/2020,3558,1814,1744
990328,Mon,3/2/2020,4903,2432,2471
990328,Tue,3/3/2020,5353,2681,2672
990328,Wed,3/4/2020,5380,2671,2709
990328,Thu,3/5/2020,5414,2729,2685
990328,Fri,3/6/2020,5706,2885,2821
990328,Sat,3/7/2020,4891,2430,2461
990328,Mon,3/9/2020,4927,2441,2486
990328,Tue,3/10/2020,5073,2549,2524
990328,Wed,3/11/2020,5189,2612,2577
990328,Thu,3/12/2020,5198,2632,2566
990328,Fri,3/13/2020,5389,2726,2663
990328,Sat,3/14/2020,3413,1737,1676
990328,Sun,3/15/2020,3022,1525,1497
990328,Mon,3/16/2020,4570,2263,2307
990328,Tue,3/17/2020,4372,2176,2196
990328,Wed,3/18/2020,4074,2036,2038
990328,Thu,3/19/2020,3990,2013,1977
990328,Fri,3/20/2020,4199,2148,2051
990328,Sat,3/21/2020,2611,1332,1279
990328,Sun,3/22/2020,1836,918,918
990328,Mon,3/23/2020,3736,1857,1879
990328,Tue,3/24/2020,3524,1771,1753
990328,Wed,3/25/2020,3078,1536,1542
990328,Thu,3/26/2020,3184,1592,1592
990328,Fri,3/27/2020,3162,1600,1562
990328,Sat,3/28/2020,1952,992,960
990328,Sun,3/29/2020,1689,828,861
990328,Mon,3/30/2020,3331,1684,1647
990328,Tue,3/31/2020,3225,1615,1610
990328,Wed,4/1/2020,3421,1700,1721
990328,Thu,4/2/2020,3461,1727,1734
990328,Fri,4/3/2020,3799,1951,1848
990328,Sat,4/4/2020,2328,1170,1158
990328,Sun,4/5/2020,1766,870,896
990328,Mon,4/6/2020,3400,1712,1688
990328,Tue,4/7/2020,3450,1711,1739
990328,Wed,4/8/2020,3668,1838,1830
990329,Wed,1/1/2020,37474,15261,22213
990329,Thu,1/2/2020,65527,27631,37896
990329,Fri,1/3/2020,68360,28251,40109
990329,Sun,1/5/2020,43045,17652,25393
990329,Mon,1/6/2020,66027,28264,37763
990329,Tue,1/7/2020,69880,30142,39738
990329,Wed,1/8/2020,71689,31000,40689
990329,Thu,1/9/2020,72400,30771,41629
990329,Fri,1/10/2020,69921,29173,40748
990329,Sat,1/11/2020,46654,18757,27897
990329,Sun,1/12/2020,42943,17998,24945
990329,Mon,1/13/2020,66299,28540,37759
990329,Tue,1/14/2020,70505,30066,40439
990329,Wed,1/15/2020,70925,29904,41021
990329,Thu,1/16/2020,73531,31670,41861
990329,Fri,1/17/2020,74585,30632,43953
990329,Sat,1/18/2020,44549,18184,26365
990329,Sun,1/19/2020,39522,16723,22799
990329,Mon,1/20/2020,63373,27058,36315
990329,Tue,1/21/2020,70453,30412,40041
990329,Wed,1/22/2020,71083,30445,40638
990329,Thu,1/23/2020,71527,30306,41221
990329,Fri,1/24/2020,72511,29918,42593
990329,Sat,1/25/2020,48569,20251,28318
990329,Tue,1/28/2020,70494,28235,42259
990329,Wed,1/29/2020,71126,29985,41141
990329,Thu,1/30/2020,73534,31288,42246
990329,Fri,1/31/2020,74077,31000,43077
990329,Sun,2/2/2020,41129,17311,23818
990329,Mon,2/3/2020,66844,28703,38141
990329,Wed,2/5/2020,68022,28233,39789
990329,Thu,2/6/2020,67771,28868,38903
990329,Fri,2/7/2020,72911,31029,41882
990329,Sat,2/8/2020,50540,20425,30115
990329,Sun,2/9/2020,42178,17055,25123
990329,Mon,2/10/2020,67781,28995,38786
990329,Wed,2/12/2020,69385,28737,40648
990329,Thu,2/13/2020,68252,29122,39130
990329,Fri,2/14/2020,73764,30792,42972
990329,Sat,2/15/2020,52755,21193,31562
990329,Sun,2/16/2020,44977,18475,26502
990329,Mon,2/17/2020,68022,28602,39420
990329,Tue,2/18/2020,72273,30531,41742
990329,Wed,2/19/2020,73916,31926,41990
990329,Thu,2/20/2020,66092,26585,39507
990329,Fri,2/21/2020,73231,30109,43122
990329,Sat,2/22/2020,53944,22355,31589
990329,Sun,2/23/2020,45988,19308,26680
990329,Mon,2/24/2020,66190,28198,37992
990329,Tue,2/25/2020,71469,30320,41149
990329,Wed,2/26/2020,67614,28681,38933
990329,Thu,2/27/2020,74178,30444,43734
990329,Fri,2/28/2020,74826,30138,44688
990329,Sat,2/29/2020,54299,22021,32278
990329,Sun,3/1/2020,47212,19820,27392
990329,Mon,3/2/2020,68352,29274,39078
990329,Tue,3/3/2020,70982,30614,40368
990329,Wed,3/4/2020,74679,31834,42845
990329,Thu,3/5/2020,76954,33080,43874
990329,Fri,3/6/2020,78477,33046,45431
990329,Sat,3/7/2020,55268,22774,32494
990329,Sun,3/8/2020,48414,20144,28270
990329,Mon,3/9/2020,68814,29216,39598
990329,Tue,3/10/2020,72885,31293,41592
990329,Wed,3/11/2020,74773,31979,42794
990329,Thu,3/12/2020,74045,31308,42737
990329,Fri,3/13/2020,73334,30564,42770
990329,Sat,3/14/2020,45750,18752,26998
990329,Sun,3/15/2020,41676,17556,24120
990329,Mon,3/16/2020,61355,26794,34561
990329,Tue,3/17/2020,62981,27377,35604
990329,Wed,3/18/2020,59805,25761,34044
990329,Thu,3/19/2020,57832,25074,32758
990329,Fri,3/20/2020,56915,24098,32817
990329,Sat,3/21/2020,38923,16434,22489
990329,Sun,3/22/2020,29789,12770,17019
990329,Mon,3/23/2020,48921,21441,27480
990329,Tue,3/24/2020,50933,22189,28744
990329,Wed,3/25/2020,47278,20655,26623
990329,Thu,3/26/2020,46958,20812,26146
990329,Fri,3/27/2020,44384,18814,25570
990329,Sat,3/28/2020,28684,12289,16395
990329,Sun,3/29/2020,23939,10705,13234
990329,Mon,3/30/2020,43156,19383,23773
990329,Tue,3/31/2020,46976,20679,26297
990329,Wed,4/1/2020,47344,20535,26809
990329,Thu,4/2/2020,47311,21004,26307
990329,Fri,4/3/2020,46384,20352,26032
990329,Sat,4/4/2020,29294,12877,16417
990329,Sun,4/5/2020,23389,10395,12994
990329,Mon,4/6/2020,42360,19193,23167
990329,Tue,4/7/2020,46187,20503,25684
990329,Wed,4/8/2020,46333,20444,25889
990404,Wed,1/1/2020,8447,4192,4255
990404,Thu,1/2/2020,13934,7071,6863
990404,Fri,1/3/2020,14989,7551,7438
990404,Sat,1/4/2020,11777,5850,5927
990404,Sun,1/5/2020,10308,5156,5152
990404,Mon,1/6/2020,13822,7064,6758
990404,Tue,1/7/2020,14152,7177,6975
990404,Wed,1/8/2020,14107,7138,6969
990404,Thu,1/9/2020,14455,7312,7143
990404,Fri,1/10/2020,15078,7632,7446
990404,Sat,1/11/2020,10316,5085,5231
990404,Sun,1/12/2020,9774,4762,5012
990404,Mon,1/13/2020,13919,7011,6908
990404,Tue,1/14/2020,14414,7334,7080
990404,Wed,1/15/2020,14250,7248,7002
990404,Thu,1/16/2020,14630,7490,7140
990404,Fri,1/17/2020,14687,7516,7171
990404,Sat,1/18/2020,10181,5082,5099
990404,Sun,1/19/2020,9181,4568,4613
990404,Mon,1/20/2020,13151,6622,6529
990404,Tue,1/21/2020,14243,7245,6998
990404,Wed,1/22/2020,14517,7322,7195
990404,Thu,1/23/2020,13827,7015,6812
990404,Fri,1/24/2020,14682,7432,7250
990404,Sat,1/25/2020,11427,5716,5711
990404,Sun,1/26/2020,10424,5240,5184
990404,Mon,1/27/2020,13769,6998,6771
990404,Tue,1/28/2020,13973,7115,6858
990404,Wed,1/29/2020,13977,7117,6860
990404,Thu,1/30/2020,14338,7263,7075
990404,Fri,1/31/2020,15474,7910,7564
990404,Sat,2/1/2020,12337,6189,6148
990404,Sun,2/2/2020,10989,5527,5462
990404,Mon,2/3/2020,13807,7063,6744
990404,Tue,2/4/2020,14042,7109,6933
990404,Wed,2/5/2020,13405,6927,6478
990404,Sun,2/9/2020,9549,4799,4750
990404,Mon,2/10/2020,13848,7020,6828
990404,Tue,2/11/2020,14606,7402,7204
990404,Wed,2/12/2020,13677,7034,6643
990404,Thu,2/13/2020,11981,6134,5847
990404,Fri,2/14/2020,14446,7361,7085
990404,Sat,2/15/2020,11944,5935,6009
990404,Sun,2/16/2020,10573,5222,5351
990404,Mon,2/17/2020,13534,6783,6751
990404,Tue,2/18/2020,14278,7164,7114
990404,Wed,2/19/2020,14393,7212,7181
990404,Thu,2/20/2020,14527,7370,7157
990404,Fri,2/21/2020,15931,8032,7899
990404,Sat,2/22/2020,13875,6880,6995
990404,Sun,2/23/2020,11893,5925,5968
990404,Mon,2/24/2020,13956,7075,6881
990404,Tue,2/25/2020,12961,6634,6327
990404,Wed,2/26/2020,11969,6155,5814
990404,Thu,2/27/2020,14201,7214,6987
990404,Fri,2/28/2020,15563,7831,7732
990404,Sat,2/29/2020,13219,6634,6585
990404,Sun,3/1/2020,11828,5974,5854
990404,Mon,3/2/2020,14207,7212,6995
990404,Tue,3/3/2020,15284,7775,7509
990404,Wed,3/4/2020,15008,7655,7353
990404,Thu,3/5/2020,15381,7776,7605
990404,Fri,3/6/2020,16143,8091,8052
990404,Sat,3/7/2020,14131,7040,7091
990404,Sun,3/8/2020,12929,6504,6425
990404,Mon,3/9/2020,14062,7096,6966
990404,Tue,3/10/2020,14662,7395,7267
990404,Wed,3/11/2020,14763,7454,7309
990404,Thu,3/12/2020,14973,7582,7391
990404,Fri,3/13/2020,15921,8133,7788
990404,Sat,3/14/2020,11555,5861,5694
990404,Sun,3/15/2020,9799,4945,4854
990404,Mon,3/16/2020,13301,6852,6449
990404,Tue,3/17/2020,12919,6517,6402
990404,Wed,3/18/2020,11901,5956,5945
990404,Thu,3/19/2020,11383,5714,5669
990404,Fri,3/20/2020,12192,6154,6038
990404,Sat,3/21/2020,8813,4408,4405
990404,Sun,3/22/2020,5680,2927,2753
990404,Mon,3/23/2020,9886,5014,4872
990404,Tue,3/24/2020,10143,5118,5025
990404,Wed,3/25/2020,9815,4951,4864
990404,Thu,3/26/2020,9298,4721,4577
990404,Fri,3/27/2020,9838,5010,4828
990404,Sat,3/28/2020,6626,3332,3294
990404,Sun,3/29/2020,5423,2753,2670
990404,Mon,3/30/2020,9733,4947,4786
990404,Tue,3/31/2020,9765,4925,4840
990404,Wed,4/1/2020,10055,5134,4921
990404,Thu,4/2/2020,11058,5689,5369
990404,Fri,4/3/2020,11211,5653,5558
990404,Sat,4/4/2020,7560,3770,3790
990404,Sun,4/5/2020,6912,3506,3406
990404,Mon,4/6/2020,10051,5128,4923
990404,Tue,4/7/2020,10765,5493,5272
990404,Wed,4/8/2020,10648,5430,5218
990405,Wed,1/1/2020,32979,14193,18786
990405,Thu,1/2/2020,46948,21356,25592
990405,Fri,1/3/2020,49308,22071,27237
990405,Sat,1/4/2020,40106,17758,22348
990405,Sun,1/5/2020,37289,16785,20504
990405,Mon,1/6/2020,45059,19717,25342
990405,Tue,1/7/2020,45883,19983,25900
990405,Wed,1/8/2020,46651,20443,26208
990405,Thu,1/9/2020,47125,20657,26468
990405,Fri,1/10/2020,49414,22579,26835
990405,Sat,1/11/2020,32391,13827,18564
990405,Sun,1/12/2020,35832,16026,19806
990405,Mon,1/13/2020,45378,19815,25563
990405,Tue,1/14/2020,46655,20126,26529
990405,Wed,1/15/2020,45740,20111,25629
990405,Thu,1/16/2020,48090,21219,26871
990405,Fri,1/17/2020,48618,22974,25644
990405,Sat,1/18/2020,32318,13657,18661
990405,Sun,1/19/2020,32181,13693,18488
990405,Mon,1/20/2020,44586,20298,24288
990405,Tue,1/21/2020,46065,20046,26019
990405,Wed,1/22/2020,46650,20458,26192
990405,Thu,1/23/2020,45420,20221,25199
990405,Fri,1/24/2020,49119,22701,26418
990405,Sat,1/25/2020,34470,14682,19788
990405,Sun,1/26/2020,34411,14953,19458
990405,Mon,1/27/2020,44469,19242,25227
990405,Tue,1/28/2020,45776,19885,25891
990405,Wed,1/29/2020,45875,19781,26094
990405,Thu,1/30/2020,47619,20942,26677
990405,Fri,1/31/2020,50410,22779,27631
990405,Sat,2/1/2020,37802,16278,21524
990405,Sun,2/2/2020,33634,14574,19060
990405,Mon,2/3/2020,45517,19917,25600
990405,Tue,2/4/2020,45867,19893,25974
990405,Wed,2/5/2020,42320,18146,24174
990405,Sun,2/9/2020,32853,13958,18895
990405,Mon,2/10/2020,44757,19336,25421
990405,Tue,2/11/2020,47044,20501,26543
990405,Wed,2/12/2020,44578,19557,25021
990405,Thu,2/13/2020,41740,18835,22905
990405,Fri,2/14/2020,50371,23510,26861
990405,Sat,2/15/2020,39417,17114,22303
990405,Sun,2/16/2020,39239,17535,21704
990405,Mon,2/17/2020,47619,21637,25982
990405,Tue,2/18/2020,47273,20749,26524
990405,Wed,2/19/2020,46707,20621,26086
990405,Thu,2/20/2020,48998,21646,27352
990405,Fri,2/21/2020,52090,23842,28248
990405,Sat,2/22/2020,41865,18108,23757
990405,Sun,2/23/2020,39141,17525,21616
990405,Mon,2/24/2020,45832,20243,25589
990405,Tue,2/25/2020,42819,18431,24388
990405,Wed,2/26/2020,41216,17657,23559
990405,Thu,2/27/2020,49376,22227,27149
990405,Fri,2/28/2020,54570,25160,29410
990405,Sat,2/29/2020,42699,18754,23945
990405,Sun,3/1/2020,40655,18403,22252
990405,Mon,3/2/2020,46954,20531,26423
990405,Tue,3/3/2020,48199,21062,27137
990405,Wed,3/4/2020,48455,21347,27108
990405,Thu,3/5/2020,50407,22581,27826
990405,Fri,3/6/2020,54831,25304,29527
990405,Sat,3/7/2020,43170,18895,24275
990405,Sun,3/8/2020,40959,18539,22420
990405,Mon,3/9/2020,46379,20651,25728
990405,Tue,3/10/2020,47824,20987,26837
990405,Wed,3/11/2020,48447,21449,26998
990405,Thu,3/12/2020,50393,23013,27380
990405,Fri,3/13/2020,53166,24812,28354
990405,Sat,3/14/2020,37703,16277,21426
990405,Sun,3/15/2020,35915,15566,20349
990405,Mon,3/16/2020,43869,19273,24596
990405,Tue,3/17/2020,43604,18834,24770
990405,Wed,3/18/2020,41482,18423,23059
990405,Thu,3/19/2020,40385,17804,22581
990405,Fri,3/20/2020,42076,18835,23241
990405,Sat,3/21/2020,29818,12814,17004
990405,Sun,3/22/2020,21860,9055,12805
990405,Mon,3/23/2020,34161,14453,19708
990405,Tue,3/24/2020,35847,15034,20813
990405,Wed,3/25/2020,34366,14430,19936
990405,Thu,3/26/2020,34359,14309,20050
990405,Fri,3/27/2020,33650,14341,19309
990405,Sat,3/28/2020,21645,9074,12571
990405,Sun,3/29/2020,18583,7798,10785
990405,Mon,3/30/2020,32597,13541,19056
990405,Tue,3/31/2020,33747,14019,19728
990405,Wed,4/1/2020,33377,14022,19355
990405,Thu,4/2/2020,31601,13292,18309
990405,Fri,4/3/2020,33033,14233,18800
990405,Sat,4/4/2020,21378,8823,12555
990405,Sun,4/5/2020,18656,7685,10971
990405,Mon,4/6/2020,31490,13079,18411
990405,Tue,4/7/2020,33503,14211,19292
990405,Wed,4/8/2020,31930,13530,18400
990408,Wed,1/1/2020,2817,1397,1420
990408,Thu,1/2/2020,4649,2305,2344
990408,Fri,1/3/2020,5129,2595,2534
990408,Sat,1/4/2020,3948,1954,1994
990408,Sun,1/5/2020,3048,1530,1518
990408,Mon,1/6/2020,4766,2386,2380
990408,Tue,1/7/2020,4918,2510,2408
990408,Wed,1/8/2020,4983,2514,2469
990408,Thu,1/9/2020,5151,2592,2559
990408,Fri,1/10/2020,5302,2704,2598
990408,Sat,1/11/2020,3997,2009,1988
990408,Sun,1/12/2020,3223,1620,1603
990408,Mon,1/13/2020,4787,2396,2391
990408,Tue,1/14/2020,4894,2452,2442
990408,Wed,1/15/2020,4821,2428,2393
990408,Thu,1/16/2020,4962,2503,2459
990408,Fri,1/17/2020,5226,2625,2601
990408,Sat,1/18/2020,3670,1909,1761
990408,Sun,1/19/2020,2681,1352,1329
990408,Mon,1/20/2020,4321,2128,2193
990408,Tue,1/21/2020,4858,2448,2410
990408,Wed,1/22/2020,4885,2448,2437
990408,Thu,1/23/2020,4990,2530,2460
990408,Fri,1/24/2020,5244,2642,2602
990408,Sat,1/25/2020,3749,1897,1852
990408,Sun,1/26/2020,3096,1531,1565
990408,Mon,1/27/2020,4630,2299,2331
990408,Tue,1/28/2020,4928,2477,2451
990408,Wed,1/29/2020,4786,2393,2393
990408,Thu,1/30/2020,4920,2517,2403
990408,Fri,1/31/2020,5451,2751,2700
990408,Sat,2/1/2020,4324,2197,2127
990408,Sun,2/2/2020,3440,1711,1729
990408,Mon,2/3/2020,5005,2483,2522
990408,Tue,2/4/2020,4948,2504,2444
990408,Wed,2/5/2020,4743,2401,2342
990408,Sun,2/9/2020,2981,1505,1476
990408,Mon,2/10/2020,4750,2360,2390
990408,Tue,2/11/2020,5116,2582,2534
990408,Wed,2/12/2020,4705,2340,2365
990408,Thu,2/13/2020,4006,2044,1962
990408,Fri,2/14/2020,5114,2579,2535
990408,Sat,2/15/2020,4159,2185,1974
990408,Sun,2/16/2020,3263,1631,1632
990408,Mon,2/17/2020,4710,2333,2377
990408,Tue,2/18/2020,4902,2467,2435
990408,Wed,2/19/2020,5070,2560,2510
990408,Thu,2/20/2020,5043,2535,2508
990408,Fri,2/21/2020,5681,2902,2779
990408,Sat,2/22/2020,4858,2460,2398
990408,Sun,2/23/2020,3663,1839,1824
990408,Mon,2/24/2020,4672,2292,2380
990408,Tue,2/25/2020,4727,2409,2318
990408,Wed,2/26/2020,3898,1950,1948
990408,Thu,2/27/2020,4683,2384,2299
990408,Fri,2/28/2020,5655,2880,2775
990408,Sat,2/29/2020,4705,2397,2308
990408,Sun,3/1/2020,3642,1817,1825
990408,Mon,3/2/2020,5088,2550,2538
990408,Tue,3/3/2020,5271,2694,2577
990408,Wed,3/4/2020,5455,2766,2689
990408,Thu,3/5/2020,5394,2755,2639
990408,Fri,3/6/2020,5731,2908,2823
990408,Sat,3/7/2020,5305,2704,2601
990408,Sun,3/8/2020,3880,1957,1923
990408,Mon,3/9/2020,5017,2482,2535
990408,Tue,3/10/2020,4947,2505,2442
990408,Wed,3/11/2020,5057,2566,2491
990408,Thu,3/12/2020,5283,2681,2602
990408,Fri,3/13/2020,5898,3007,2891
990408,Sat,3/14/2020,3692,1846,1846
990408,Sun,3/15/2020,3311,1651,1660
990408,Mon,3/16/2020,4652,2311,2341
990408,Tue,3/17/2020,4620,2336,2284
990408,Wed,3/18/2020,4238,2149,2089
990408,Thu,3/19/2020,4324,2199,2125
990408,Fri,3/20/2020,4641,2356,2285
990408,Sat,3/21/2020,3275,1645,1630
990408,Sun,3/22/2020,2232,1133,1099
990408,Mon,3/23/2020,3917,1965,1952
990408,Tue,3/24/2020,3935,1968,1967
990408,Wed,3/25/2020,3446,1741,1705
990408,Thu,3/26/2020,3345,1687,1658
990408,Fri,3/27/2020,3541,1790,1751
990408,Sat,3/28/2020,2366,1192,1174
990408,Sun,3/29/2020,1908,946,962
990408,Mon,3/30/2020,3604,1815,1789
990408,Tue,3/31/2020,3520,1787,1733
990408,Wed,4/1/2020,3707,1881,1826
990408,Thu,4/2/2020,3958,2007,1951
990408,Fri,4/3/2020,4544,2317,2227
990408,Sat,4/4/2020,2895,1464,1431
990408,Sun,4/5/2020,2606,1312,1294
990408,Mon,4/6/2020,4111,2040,2071
990408,Tue,4/7/2020,4137,2074,2063
990408,Wed,4/8/2020,4291,2159,2132
990409,Thu,1/2/2020,1199,571,628
990409,Fri,1/3/2020,1265,632,633
990409,Sat,1/4/2020,1049,558,491
990409,Tue,1/7/2020,1568,902,666
990409,Wed,1/8/2020,1374,766,608
990409,Thu,1/9/2020,1330,677,653
990409,Fri,1/10/2020,1227,603,624
990409,Sat,1/11/2020,894,468,426
990409,Sun,1/12/2020,837,423,414
990409,Mon,1/13/2020,1234,591,643
990409,Tue,1/14/2020,1164,562,602
990409,Wed,1/15/2020,1148,547,601
990409,Thu,1/16/2020,1301,648,653
990409,Fri,1/17/2020,1476,792,684
990409,Sat,1/18/2020,823,447,376
990409,Mon,1/20/2020,1057,517,540
990409,Tue,1/21/2020,1318,714,604
990409,Wed,1/22/2020,1411,814,597
990409,Thu,1/23/2020,1236,616,620
990409,Fri,1/24/2020,1201,597,604
990409,Sat,1/25/2020,944,475,469
990409,Sun,1/26/2020,776,378,398
990409,Mon,1/27/2020,1098,542,556
990409,Tue,1/28/2020,1086,533,553
990409,Wed,1/29/2020,1137,561,576
990409,Thu,1/30/2020,1193,585,608
990409,Fri,1/31/2020,1369,679,690
990409,Sat,2/1/2020,1135,636,499
990409,Sun,2/2/2020,1055,580,475
990409,Mon,2/3/2020,1357,746,611
990409,Tue,2/4/2020,1178,608,570
990409,Wed,2/5/2020,1183,633,550
990409,Sun,2/9/2020,913,512,401
990409,Mon,2/10/2020,1113,557,556
990409,Tue,2/11/2020,1312,684,628
990409,Wed,2/12/2020,1193,598,595
990409,Thu,2/13/2020,1224,728,496
990409,Sun,2/16/2020,1015,545,470
990409,Mon,2/17/2020,1066,517,549
990409,Tue,2/18/2020,1197,583,614
990409,Wed,2/19/2020,1253,616,637
990409,Thu,2/20/2020,1302,668,634
990409,Fri,2/21/2020,1379,688,691
990409,Sat,2/22/2020,1179,622,557
990409,Sun,2/23/2020,1044,591,453
990409,Mon,2/24/2020,1179,601,578
990409,Tue,2/25/2020,1169,587,582
990409,Thu,2/27/2020,1306,722,584
990409,Fri,2/28/2020,1387,763,624
990409,Sat,2/29/2020,1200,697,503
990409,Sun,3/1/2020,1004,566,438
990409,Tue,3/3/2020,1383,735,648
990409,Wed,3/4/2020,1238,632,606
990409,Thu,3/5/2020,1364,722,642
990409,Fri,3/6/2020,1390,687,703
990409,Sat,3/7/2020,1271,725,546
990409,Sun,3/8/2020,951,489,462
990409,Mon,3/9/2020,1315,721,594
990409,Tue,3/10/2020,1201,582,619
990409,Thu,3/12/2020,1361,709,652
990409,Fri,3/13/2020,1437,756,681
990409,Sat,3/14/2020,1024,509,515
990409,Sun,3/15/2020,978,527,451
990409,Mon,3/16/2020,1132,569,563
990409,Tue,3/17/2020,1291,684,607
990409,Wed,3/18/2020,1064,541,523
990409,Thu,3/19/2020,1114,584,530
990409,Sat,3/21/2020,917,491,426
990409,Sun,3/22/2020,611,306,305
990409,Mon,3/23/2020,1022,495,527
990409,Tue,3/24/2020,1004,503,501
990409,Thu,3/26/2020,975,514,461
990409,Fri,3/27/2020,938,471,467
990409,Mon,3/30/2020,968,518,450
990409,Tue,3/31/2020,949,515,434
990409,Fri,4/3/2020,1232,687,545
990409,Sat,4/4/2020,870,499,371
990409,Sun,4/5/2020,824,481,343
990409,Mon,4/6/2020,1097,617,480
990409,Tue,4/7/2020,1048,526,522
990409,Wed,4/8/2020,1097,599,498
990431,Wed,1/1/2020,31347,14997,16350
990431,Thu,1/2/2020,36908,17702,19206
990431,Fri,1/3/2020,40688,20927,19761
990431,Sat,1/4/2020,36950,19258,17692
990431,Sun,1/5/2020,36933,18003,18930
990431,Mon,1/6/2020,31713,15220,16493
990431,Tue,1/7/2020,32985,16066,16919
990431,Wed,1/8/2020,34063,16634,17429
990431,Thu,1/9/2020,35440,17721,17719
990431,Fri,1/10/2020,39353,19457,19896
990431,Sat,1/11/2020,27660,13465,14195
990431,Mon,1/13/2020,31281,14520,16761
990431,Tue,1/14/2020,32962,16096,16866
990431,Wed,1/15/2020,33186,16513,16673
990431,Thu,1/16/2020,35898,18183,17715
990431,Fri,1/17/2020,42316,22344,19972
990431,Sat,1/18/2020,26613,13677,12936
990431,Sun,1/19/2020,29818,14812,15006
990431,Mon,1/20/2020,36572,17192,19380
990431,Tue,1/21/2020,32895,16014,16881
990431,Wed,1/22/2020,33256,16504,16752
990431,Thu,1/23/2020,33489,17075,16414
990431,Fri,1/24/2020,40153,20383,19770
990431,Sat,1/25/2020,27103,13592,13511
990431,Sun,1/26/2020,32771,16442,16329
990431,Mon,1/27/2020,30365,14534,15831
990431,Tue,1/28/2020,32194,15710,16484
990431,Wed,1/29/2020,32867,16218,16649
990431,Thu,1/30/2020,35572,17881,17691
990431,Fri,1/31/2020,40876,21228,19648
990431,Sat,2/1/2020,30484,15626,14858
990431,Sun,2/2/2020,30330,14726,15604
990431,Mon,2/3/2020,31580,14828,16752
990431,Tue,2/4/2020,32230,15971,16259
990431,Wed,2/5/2020,31796,15912,15884
990431,Thu,2/6/2020,31975,16297,15678
990431,Fri,2/7/2020,40286,20636,19650
990431,Sat,2/8/2020,30472,15199,15273
990431,Sun,2/9/2020,31485,15636,15849
990431,Mon,2/10/2020,31785,15550,16235
990431,Tue,2/11/2020,33353,16355,16998
990431,Wed,2/12/2020,32345,15963,16382
990431,Thu,2/13/2020,33499,17372,16127
990431,Fri,2/14/2020,43716,23120,20596
990431,Sat,2/15/2020,34391,17514,16877
990431,Mon,2/17/2020,38433,18439,19994
990431,Tue,2/18/2020,34339,16825,17514
990431,Wed,2/19/2020,34335,17370,16965
990431,Thu,2/20/2020,37759,19160,18599
990431,Fri,2/21/2020,44289,22545,21744
990431,Sat,2/22/2020,35203,17656,17547
990431,Mon,2/24/2020,32597,15745,16852
990431,Tue,2/25/2020,31724,15702,16022
990431,Thu,2/27/2020,38098,19449,18649
990431,Fri,2/28/2020,46646,23970,22676
990431,Sat,2/29/2020,36591,18914,17677
990431,Mon,3/2/2020,33703,16626,17077
990431,Tue,3/3/2020,33378,15645,17733
990431,Wed,3/4/2020,35192,17612,17580
990431,Thu,3/5/2020,38759,19526,19233
990431,Fri,3/6/2020,47930,24512,23418
990431,Sat,3/7/2020,37133,18996,18137
990431,Sun,3/8/2020,41385,20692,20693
990431,Mon,3/9/2020,33690,16200,17490
990431,Tue,3/10/2020,34859,17135,17724
990431,Wed,3/11/2020,36357,18425,17932
990431,Thu,3/12/2020,40503,21307,19196
990431,Fri,3/13/2020,48519,27204,21315
990431,Sat,3/14/2020,33151,17492,15659
990431,Sun,3/15/2020,35809,17543,18266
990431,Mon,3/16/2020,30475,12881,17594
990431,Tue,3/17/2020,35525,17840,17685
990431,Wed,3/18/2020,34208,17057,17151
990431,Wed,4/8/2020,25159,12672,12487
990502,Wed,1/1/2020,4762,2404,2358
990502,Thu,1/2/2020,6555,3355,3200
990502,Fri,1/3/2020,7187,3626,3561
990502,Sat,1/4/2020,5913,2962,2951
990502,Sun,1/5/2020,5362,2697,2665
990502,Mon,1/6/2020,6742,3412,3330
990502,Tue,1/7/2020,6762,3437,3325
990502,Wed,1/8/2020,6877,3446,3431
990502,Thu,1/9/2020,7045,3569,3476
990502,Fri,1/10/2020,7167,3612,3555
990502,Sat,1/11/2020,5543,2798,2745
990502,Sun,1/12/2020,5161,2589,2572
990502,Mon,1/13/2020,6637,3350,3287
990502,Tue,1/14/2020,6701,3386,3315
990502,Wed,1/15/2020,6591,3331,3260
990502,Thu,1/16/2020,6724,3415,3309
990502,Fri,1/17/2020,7248,3617,3631
990502,Sat,1/18/2020,5761,2887,2874
990502,Sun,1/19/2020,4563,2295,2268
990502,Mon,1/20/2020,5961,3030,2931
990502,Tue,1/21/2020,6655,3384,3271
990502,Wed,1/22/2020,6651,3351,3300
990502,Thu,1/23/2020,6909,3487,3422
990502,Fri,1/24/2020,7485,3750,3735
990502,Sat,1/25/2020,5761,2918,2843
990502,Sun,1/26/2020,5229,2628,2601
990502,Mon,1/27/2020,6584,3353,3231
990502,Tue,1/28/2020,6633,3369,3264
990502,Wed,1/29/2020,6772,3427,3345
990502,Thu,1/30/2020,6867,3490,3377
990502,Fri,1/31/2020,7629,3834,3795
990502,Sat,2/1/2020,6477,3243,3234
990502,Sun,2/2/2020,5704,2922,2782
990502,Mon,2/3/2020,7017,3539,3478
990502,Tue,2/4/2020,6681,3406,3275
990502,Wed,2/5/2020,6626,3326,3300
990502,Thu,2/6/2020,6378,3253,3125
990502,Fri,2/7/2020,7452,3733,3719
990502,Sat,2/8/2020,6192,3135,3057
990502,Sun,2/9/2020,4804,2416,2388
990502,Mon,2/10/2020,6558,3316,3242
990502,Tue,2/11/2020,6837,3449,3388
990502,Wed,2/12/2020,6176,3136,3040
990502,Thu,2/13/2020,6379,3208,3171
990502,Fri,2/14/2020,7224,3632,3592
990502,Sat,2/15/2020,6256,3135,3121
990502,Sun,2/16/2020,5644,2851,2793
990502,Mon,2/17/2020,6324,3227,3097
990502,Tue,2/18/2020,6687,3428,3259
990502,Wed,2/19/2020,6931,3475,3456
990502,Thu,2/20/2020,6965,3517,3448
990502,Fri,2/21/2020,7890,3967,3923
990502,Sat,2/22/2020,6743,3344,3399
990502,Sun,2/23/2020,5812,2944,2868
990502,Mon,2/24/2020,6510,3300,3210
990502,Tue,2/25/2020,6683,3365,3318
990502,Wed,2/26/2020,6319,3195,3124
990502,Thu,2/27/2020,6875,3488,3387
990502,Fri,2/28/2020,7560,3771,3789
990502,Sat,2/29/2020,7027,3546,3481
990502,Sun,3/1/2020,6189,3099,3090
990502,Mon,3/2/2020,6681,3439,3242
990502,Tue,3/3/2020,7260,3640,3620
990502,Wed,3/4/2020,6961,3521,3440
990502,Thu,3/5/2020,7341,3710,3631
990502,Fri,3/6/2020,7537,3763,3774
990502,Sat,3/7/2020,7629,3825,3804
990502,Sun,3/8/2020,6444,3252,3192
990502,Mon,3/9/2020,6994,3566,3428
990502,Tue,3/10/2020,6939,3497,3442
990502,Wed,3/11/2020,6933,3533,3400
990502,Thu,3/12/2020,7122,3626,3496
990502,Fri,3/13/2020,7771,3888,3883
990502,Sat,3/14/2020,5476,2745,2731
990502,Sun,3/15/2020,5227,2665,2562
990502,Mon,3/16/2020,6506,3296,3210
990502,Tue,3/17/2020,6255,3140,3115
990502,Wed,3/18/2020,5906,2977,2929
990502,Thu,3/19/2020,5764,2875,2889
990502,Fri,3/20/2020,6291,3121,3170
990502,Sat,3/21/2020,5041,2528,2513
990502,Sun,3/22/2020,3688,1906,1782
990502,Mon,3/23/2020,5512,2782,2730
990502,Tue,3/24/2020,5449,2742,2707
990502,Wed,3/25/2020,4846,2420,2426
990502,Thu,3/26/2020,5010,2556,2454
990502,Fri,3/27/2020,5115,2542,2573
990502,Sat,3/28/2020,4122,2088,2034
990502,Mon,3/30/2020,5121,2614,2507
990502,Tue,3/31/2020,5024,2771,2253
990502,Wed,4/1/2020,4986,2502,2484
990502,Thu,4/2/2020,5365,2672,2693
990502,Fri,4/3/2020,6233,3075,3158
990502,Sat,4/4/2020,4774,2399,2375
990502,Sun,4/5/2020,3809,1978,1831
990502,Mon,4/6/2020,5274,2676,2598
990502,Tue,4/7/2020,5572,2825,2747
990502,Wed,4/8/2020,5791,2922,2869
990505,Wed,1/1/2020,2556,1326,1230
990505,Thu,1/2/2020,4256,2123,2133
990505,Fri,1/3/2020,4828,2386,2442
990505,Sat,1/4/2020,3900,1905,1995
990505,Sun,1/5/2020,2973,1545,1428
990505,Mon,1/6/2020,4527,2290,2237
990505,Tue,1/7/2020,4629,2318,2311
990505,Wed,1/8/2020,4589,2282,2307
990505,Thu,1/9/2020,4881,2423,2458
990505,Fri,1/10/2020,5051,2495,2556
990505,Sat,1/11/2020,3039,1494,1545
990505,Sun,1/12/2020,2933,1504,1429
990505,Mon,1/13/2020,4531,2267,2264
990505,Tue,1/14/2020,4618,2301,2317
990505,Wed,1/15/2020,4483,2250,2233
990505,Thu,1/16/2020,4653,2320,2333
990505,Fri,1/17/2020,5019,2472,2547
990505,Sat,1/18/2020,3640,1808,1832
990505,Sun,1/19/2020,2602,1319,1283
990505,Mon,1/20/2020,4074,2083,1991
990505,Tue,1/21/2020,4501,2265,2236
990505,Wed,1/22/2020,4631,2333,2298
990505,Thu,1/23/2020,4667,2349,2318
990505,Fri,1/24/2020,5097,2488,2609
990505,Sat,1/25/2020,3486,1736,1750
990505,Sun,1/26/2020,2930,1525,1405
990505,Mon,1/27/2020,4382,2223,2159
990505,Thu,2/27/2020,4771,2374,2397
990505,Fri,2/28/2020,5396,2718,2678
990505,Sat,2/29/2020,3835,1949,1886
990505,Sun,3/1/2020,3413,1639,1774
990505,Mon,3/2/2020,4476,2204,2272
990505,Tue,3/3/2020,4778,2336,2442
990505,Wed,3/4/2020,4847,2406,2441
990505,Thu,3/5/2020,4945,2458,2487
990505,Fri,3/6/2020,5121,2628,2493
990505,Sat,3/7/2020,4380,2213,2167
990505,Sun,3/8/2020,3504,1627,1877
990505,Mon,3/9/2020,4832,2368,2464
990505,Tue,3/10/2020,4580,2289,2291
990505,Wed,3/11/2020,4617,2272,2345
990505,Thu,3/12/2020,4786,2428,2358
990505,Fri,3/13/2020,5297,2670,2627
990505,Sat,3/14/2020,3362,1687,1675
990505,Sun,3/15/2020,2851,1365,1486
990505,Mon,3/16/2020,4265,2103,2162
990505,Tue,3/17/2020,4121,2060,2061
990505,Wed,3/18/2020,3703,1854,1849
990505,Thu,3/19/2020,3798,1902,1896
990505,Fri,3/20/2020,4038,2032,2006
990505,Sat,3/21/2020,2781,1418,1363
990505,Sun,3/22/2020,2013,937,1076
990505,Mon,3/23/2020,3484,1726,1758
990505,Tue,3/24/2020,3117,1534,1583
990505,Wed,3/25/2020,3034,1498,1536
990505,Thu,3/26/2020,3231,1607,1624
990505,Fri,3/27/2020,3117,1573,1544
990505,Sat,3/28/2020,2267,1142,1125
990505,Sun,3/29/2020,1851,877,974
990505,Mon,3/30/2020,3120,1537,1583
990505,Tue,3/31/2020,2901,1449,1452
990505,Wed,4/1/2020,3070,1520,1550
990505,Thu,4/2/2020,3021,1516,1505
990505,Fri,4/3/2020,3533,1812,1721
990505,Sat,4/4/2020,2646,1336,1310
990505,Sun,4/5/2020,1935,887,1048
990505,Mon,4/6/2020,3109,1540,1569
990505,Tue,4/7/2020,3214,1618,1596
990505,Wed,4/8/2020,3293,1657,1636
990506,Wed,1/1/2020,6975,3415,3560
990506,Thu,1/2/2020,10970,5615,5355
990506,Fri,1/3/2020,11421,5829,5592
990506,Sat,1/4/2020,8842,4408,4434
990506,Sun,1/5/2020,7639,3723,3916
990506,Mon,1/6/2020,11078,5642,5436
990506,Tue,1/7/2020,11199,5679,5520
990506,Wed,1/8/2020,11716,5946,5770
990506,Thu,1/9/2020,11616,5865,5751
990506,Fri,1/10/2020,11563,5828,5735
990506,Sat,1/11/2020,8594,4325,4269
990506,Sun,1/12/2020,7556,3758,3798
990506,Mon,1/13/2020,11131,5684,5447
990506,Tue,1/14/2020,11416,5748,5668
990506,Wed,1/15/2020,11534,5833,5701
990506,Thu,1/16/2020,11709,5910,5799
990506,Fri,1/17/2020,11933,6047,5886
990506,Sat,1/18/2020,8664,4364,4300
990506,Sun,1/19/2020,7159,3511,3648
990506,Mon,1/20/2020,10399,5302,5097
990506,Tue,1/21/2020,11099,5608,5491
990506,Wed,1/22/2020,11335,5755,5580
990506,Thu,1/23/2020,11318,5716,5602
990506,Fri,1/24/2020,11630,5945,5685
990506,Sat,1/25/2020,8572,4293,4279
990506,Sun,1/26/2020,7603,3775,3828
990506,Mon,1/27/2020,10832,5529,5303
990506,Tue,1/28/2020,11068,5588,5480
990506,Wed,1/29/2020,11103,5621,5482
990506,Thu,1/30/2020,11332,5731,5601
990506,Fri,1/31/2020,11485,5844,5641
990506,Sat,2/1/2020,9591,4821,4770
990506,Sun,2/2/2020,7970,3957,4013
990506,Mon,2/3/2020,11344,5790,5554
990506,Tue,2/4/2020,10933,5509,5424
990506,Wed,2/5/2020,11423,5739,5684
990506,Thu,2/6/2020,11244,5692,5552
990506,Fri,2/7/2020,11167,5663,5504
990506,Sat,2/8/2020,8457,4253,4204
990506,Sun,2/9/2020,7528,3747,3781
990506,Mon,2/10/2020,10873,5529,5344
990506,Tue,2/11/2020,11341,5752,5589
990506,Wed,2/12/2020,11291,5704,5587
990506,Thu,2/13/2020,11334,5732,5602
990506,Fri,2/14/2020,12289,6239,6050
990506,Sat,2/15/2020,10042,4960,5082
990506,Sun,2/16/2020,7934,3989,3945
990506,Mon,2/17/2020,11110,5647,5463
990506,Tue,2/18/2020,11309,5696,5613
990506,Wed,2/19/2020,11484,5824,5660
990506,Thu,2/20/2020,11666,5922,5744
990506,Fri,2/21/2020,12246,6190,6056
990506,Sat,2/22/2020,10023,5002,5021
990506,Sun,2/23/2020,8128,4080,4048
990506,Mon,2/24/2020,11188,5700,5488
990506,Tue,2/25/2020,11250,5664,5586
990506,Wed,2/26/2020,11558,5825,5733
990506,Thu,2/27/2020,11564,5850,5714
990506,Fri,2/28/2020,12362,6271,6091
990506,Sat,2/29/2020,9879,5013,4866
990506,Sun,3/1/2020,8591,4277,4314
990506,Mon,3/2/2020,11032,5623,5409
990506,Tue,3/3/2020,11789,5996,5793
990506,Wed,3/4/2020,11884,6025,5859
990506,Thu,3/5/2020,12468,6291,6177
990506,Fri,3/6/2020,12281,6235,6046
990506,Sat,3/7/2020,10080,5039,5041
990506,Sun,3/8/2020,8641,4369,4272
990506,Mon,3/9/2020,11858,5910,5948
990506,Tue,3/10/2020,11682,5928,5754
990506,Wed,3/11/2020,11785,5937,5848
990506,Thu,3/12/2020,11528,5824,5704
990506,Fri,3/13/2020,12253,6183,6070
990506,Sat,3/14/2020,8083,4076,4007
990506,Sun,3/15/2020,7185,3654,3531
990506,Mon,3/16/2020,10237,5182,5055
990506,Tue,3/17/2020,10085,5098,4987
990506,Wed,3/18/2020,9609,4895,4714
990506,Thu,3/19/2020,9405,4775,4630
990506,Fri,3/20/2020,9782,4913,4869
990506,Sat,3/21/2020,6868,3415,3453
990506,Sun,3/22/2020,5461,2815,2646
990506,Mon,3/23/2020,8904,4547,4357
990506,Tue,3/24/2020,7144,3606,3538
990506,Wed,3/25/2020,7914,3972,3942
990506,Thu,3/26/2020,8384,4263,4121
990506,Fri,3/27/2020,8235,4125,4110
990506,Sat,3/28/2020,6032,3007,3025
990506,Sun,3/29/2020,5140,2636,2504
990506,Mon,3/30/2020,8170,4172,3998
990506,Tue,3/31/2020,7975,4035,3940
990506,Wed,4/1/2020,8278,4191,4087
990506,Thu,4/2/2020,8569,4354,4215
990506,Fri,4/3/2020,9106,4522,4584
990506,Sat,4/4/2020,7001,3504,3497
990506,Sun,4/5/2020,4904,2582,2322
990506,Mon,4/6/2020,8268,4223,4045
990506,Tue,4/7/2020,7996,4073,3923
990506,Wed,4/8/2020,8026,4079,3947
990509,Wed,1/1/2020,2036,962,1074
990509,Fri,1/3/2020,3486,1551,1935
990509,Sat,1/4/2020,3079,1359,1720
990509,Sun,1/5/2020,2481,1172,1309
990509,Mon,1/6/2020,3266,1473,1793
990509,Tue,1/7/2020,3381,1455,1926
990509,Wed,1/8/2020,3407,1501,1906
990509,Thu,1/9/2020,3414,1502,1912
990509,Fri,1/10/2020,3460,1462,1998
990509,Sat,1/11/2020,2730,1261,1469
990509,Sun,1/12/2020,2393,1095,1298
990509,Mon,1/13/2020,3353,1485,1868
990509,Tue,1/14/2020,3503,1523,1980
990509,Wed,1/15/2020,3455,1530,1925
990509,Thu,1/16/2020,3550,1593,1957
990509,Fri,1/17/2020,3810,1618,2192
990509,Wed,1/22/2020,3875,1990,1885
990509,Thu,1/23/2020,3989,2053,1936
990509,Fri,1/24/2020,4113,2025,2088
990509,Sun,1/26/2020,2859,1489,1370
990509,Mon,1/27/2020,3582,1843,1739
990509,Tue,1/28/2020,3742,1885,1857
990509,Thu,1/30/2020,4117,2067,2050
990509,Fri,1/31/2020,4261,2130,2131
990509,Sat,2/1/2020,3603,1797,1806
990509,Sun,2/2/2020,2841,1496,1345
990509,Mon,2/3/2020,3879,1995,1884
990509,Tue,2/4/2020,3928,1991,1937
990509,Wed,2/5/2020,3793,1905,1888
990509,Thu,2/6/2020,3895,1963,1932
990509,Fri,2/7/2020,4266,2103,2163
990509,Sat,2/8/2020,3375,1703,1672
990509,Sun,2/9/2020,2733,1420,1313
990509,Mon,2/10/2020,3684,1871,1813
990509,Tue,2/11/2020,3880,1955,1925
990509,Wed,2/12/2020,3782,1902,1880
990509,Thu,2/13/2020,3950,1970,1980
990509,Fri,2/14/2020,4495,2250,2245
990509,Sat,2/15/2020,3707,1873,1834
990509,Sun,2/16/2020,2857,1504,1353
990509,Mon,2/17/2020,3634,1916,1718
990509,Tue,2/18/2020,3992,2017,1975
990509,Wed,2/19/2020,3852,1972,1880
990509,Thu,2/20/2020,4005,2043,1962
990509,Fri,2/21/2020,4502,2225,2277
990509,Sun,2/23/2020,3172,1658,1514
990509,Mon,2/24/2020,3665,1878,1787
990509,Thu,2/27/2020,3926,2011,1915
990509,Fri,2/28/2020,4352,2201,2151
990509,Sat,2/29/2020,4273,2161,2112
990509,Sun,3/1/2020,3318,1729,1589
990509,Mon,3/2/2020,3595,1857,1738
990509,Tue,3/3/2020,4067,2058,2009
990509,Wed,3/4/2020,3982,2007,1975
990509,Thu,3/5/2020,4214,2120,2094
990509,Fri,3/6/2020,4435,2243,2192
990509,Sat,3/7/2020,4179,2117,2062
990509,Sun,3/8/2020,3377,1748,1629
990509,Mon,3/9/2020,3770,1922,1848
990509,Tue,3/10/2020,4044,2056,1988
990509,Wed,3/11/2020,4069,2068,2001
990509,Thu,3/12/2020,3997,2008,1989
990509,Fri,3/13/2020,4562,2296,2266
990509,Sat,3/14/2020,3058,1538,1520
990509,Sun,3/15/2020,2713,1391,1322
990509,Mon,3/16/2020,3607,1832,1775
990509,Tue,3/17/2020,3523,1771,1752
990509,Wed,3/18/2020,3187,1624,1563
990509,Thu,3/19/2020,3170,1621,1549
990509,Fri,3/20/2020,3471,1774,1697
990509,Sat,3/21/2020,2507,1266,1241
990509,Sun,3/22/2020,1915,994,921
990509,Mon,3/23/2020,3089,1575,1514
990509,Tue,3/24/2020,2926,1485,1441
990509,Wed,3/25/2020,2664,1363,1301
990509,Thu,3/26/2020,2639,1330,1309
990509,Fri,3/27/2020,2816,1432,1384
990509,Sat,3/28/2020,2095,1067,1028
990509,Sun,3/29/2020,1683,882,801
990509,Mon,3/30/2020,2794,1431,1363
990509,Tue,3/31/2020,2738,1399,1339
990509,Wed,4/1/2020,2712,1370,1342
990509,Thu,4/2/2020,2907,1457,1450
990509,Fri,4/3/2020,3171,1598,1573
990509,Sat,4/4/2020,2385,1210,1175
990509,Sun,4/5/2020,1940,989,951
990509,Mon,4/6/2020,2881,1495,1386
990509,Tue,4/7/2020,2961,1521,1440
990509,Wed,4/8/2020,2954,1497,1457
990601,Wed,1/1/2020,620,298,322
990601,Thu,1/2/2020,1374,636,738
990601,Fri,1/3/2020,1384,663,721
990601,Sat,1/4/2020,840,404,436
990601,Sun,1/5/2020,805,377,428
990601,Mon,1/6/2020,1315,610,705
990601,Tue,1/7/2020,1480,720,760
990601,Wed,1/8/2020,1426,692,734
990601,Thu,1/9/2020,1468,706,762
990601,Fri,1/10/2020,1423,716,707
990601,Sat,1/11/2020,828,423,405
990601,Sun,1/12/2020,746,380,366
990601,Mon,1/13/2020,1423,682,741
990601,Tue,1/14/2020,1495,724,771
990601,Wed,1/15/2020,1395,694,701
990601,Thu,1/16/2020,1464,728,736
990601,Fri,1/17/2020,1622,835,787
990601,Sat,1/18/2020,953,490,463
990601,Sun,1/19/2020,714,367,347
990601,Mon,1/20/2020,1257,617,640
990601,Tue,1/21/2020,1453,710,743
990601,Wed,1/22/2020,1398,687,711
990601,Thu,1/23/2020,1424,687,737
990601,Fri,1/24/2020,1500,767,733
990601,Sat,1/25/2020,861,451,410
990601,Sun,1/26/2020,816,402,414
990601,Mon,1/27/2020,1294,616,678
990601,Tue,1/28/2020,1319,650,669
990601,Thu,1/30/2020,1355,663,692
990601,Fri,1/31/2020,1344,695,649
990601,Sat,2/1/2020,945,509,436
990601,Sun,2/2/2020,804,409,395
990601,Mon,2/3/2020,1332,655,677
990601,Tue,2/4/2020,1317,647,670
990601,Wed,2/5/2020,1208,586,622
990601,Thu,2/6/2020,1419,699,720
990601,Fri,2/7/2020,1398,710,688
990601,Sat,2/8/2020,818,417,401
990601,Sun,2/9/2020,716,352,364
990601,Mon,2/10/2020,1248,593,655
990601,Tue,2/11/2020,1358,677,681
990601,Wed,2/12/2020,1327,678,649
990601,Thu,2/13/2020,1347,672,675
990601,Fri,2/14/2020,1517,761,756
990601,Sat,2/15/2020,1052,548,504
990601,Sun,2/16/2020,904,451,453
990601,Mon,2/17/2020,1301,624,677
990601,Tue,2/18/2020,1367,666,701
990601,Wed,2/19/2020,1270,621,649
990601,Thu,2/20/2020,1354,661,693
990601,Fri,2/21/2020,1499,780,719
990601,Sat,2/22/2020,1008,513,495
990601,Sun,2/23/2020,862,421,441
990601,Mon,2/24/2020,1200,562,638
990601,Thu,2/27/2020,1329,662,667
990601,Fri,2/28/2020,1489,756,733
990601,Sat,2/29/2020,1166,607,559
990601,Sun,3/1/2020,908,437,471
990601,Mon,3/2/2020,1265,616,649
990601,Tue,3/3/2020,1426,696,730
990601,Wed,3/4/2020,1321,650,671
990601,Thu,3/5/2020,1390,698,692
990601,Fri,3/6/2020,1526,761,765
990601,Sat,3/7/2020,1224,629,595
990601,Sun,3/8/2020,1013,490,523
990601,Mon,3/9/2020,1336,644,692
990601,Tue,3/10/2020,1304,632,672
990601,Wed,3/11/2020,1380,694,686
990601,Thu,3/12/2020,1324,657,667
990601,Fri,3/13/2020,1465,754,711
990601,Sat,3/14/2020,838,444,394
990601,Sun,3/15/2020,758,380,378
990601,Mon,3/16/2020,1246,589,657
990601,Tue,3/17/2020,1269,631,638
990601,Wed,3/18/2020,1115,546,569
990601,Thu,3/19/2020,1084,547,537
990601,Fri,3/20/2020,1163,584,579
990601,Sat,3/21/2020,788,391,397
990601,Sun,3/22/2020,522,267,255
990601,Mon,3/23/2020,1193,575,618
990601,Tue,3/24/2020,1153,571,582
990601,Wed,3/25/2020,1073,530,543
990601,Thu,3/26/2020,1060,529,531
990601,Fri,3/27/2020,1067,527,540
990601,Sat,3/28/2020,577,281,296
990601,Sun,3/29/2020,513,255,258
990601,Mon,3/30/2020,1067,520,547
990601,Tue,3/31/2020,1032,503,529
990601,Wed,4/1/2020,1061,528,533
990601,Thu,4/2/2020,1138,587,551
990601,Fri,4/3/2020,1083,559,524
990601,Sat,4/4/2020,747,371,376
990601,Sun,4/5/2020,586,272,314
990601,Mon,4/6/2020,1187,597,590
990601,Tue,4/7/2020,1194,618,576
990601,Wed,4/8/2020,1217,601,616
990602,Wed,1/1/2020,426,213,213
990602,Thu,1/2/2020,604,303,301
990602,Fri,1/3/2020,692,346,346
990602,Sat,1/4/2020,536,266,270
990602,Sun,1/5/2020,542,270,272
990602,Mon,1/6/2020,654,338,316
990602,Tue,1/7/2020,767,382,385
990602,Wed,1/8/2020,778,400,378
990602,Thu,1/9/2020,764,378,386
990602,Fri,1/10/2020,713,360,353
990602,Sat,1/11/2020,613,308,305
990602,Sun,1/12/2020,482,240,242
990602,Mon,1/13/2020,696,345,351
990602,Tue,1/14/2020,740,368,372
990602,Wed,1/15/2020,719,361,358
990602,Thu,1/16/2020,717,362,355
990602,Fri,1/17/2020,727,372,355
990602,Sat,1/18/2020,556,291,265
990602,Sun,1/19/2020,464,232,232
990602,Mon,1/20/2020,571,289,282
990602,Tue,1/21/2020,653,324,329
990602,Wed,1/22/2020,715,357,358
990602,Thu,1/23/2020,756,386,370
990602,Fri,1/24/2020,706,358,348
990602,Sat,1/25/2020,677,348,329
990602,Sun,1/26/2020,507,258,249
990602,Mon,1/27/2020,663,338,325
990602,Tue,1/28/2020,643,325,318
990602,Thu,1/30/2020,738,377,361
990602,Fri,1/31/2020,764,386,378
990602,Sat,2/1/2020,652,337,315
990602,Sun,2/2/2020,557,272,285
990602,Mon,2/3/2020,665,329,336
990602,Tue,2/4/2020,570,281,289
990602,Wed,2/5/2020,668,332,336
990602,Thu,2/6/2020,606,306,300
990602,Fri,2/7/2020,723,367,356
990602,Sat,2/8/2020,573,286,287
990602,Sun,2/9/2020,478,238,240
990602,Mon,2/10/2020,643,312,331
990602,Tue,2/11/2020,660,340,320
990602,Wed,2/12/2020,642,315,327
990602,Thu,2/13/2020,690,343,347
990602,Fri,2/14/2020,704,349,355
990602,Sat,2/15/2020,684,343,341
990602,Sun,2/16/2020,493,248,245
990602,Mon,2/17/2020,571,280,291
990602,Tue,2/18/2020,656,338,318
990602,Wed,2/19/2020,675,341,334
990602,Thu,2/20/2020,694,340,354
990602,Fri,2/21/2020,697,354,343
990602,Sat,2/22/2020,699,360,339
990602,Sun,2/23/2020,583,284,299
990602,Mon,2/24/2020,684,335,349
990602,Thu,2/27/2020,717,360,357
990602,Fri,2/28/2020,734,372,362
990602,Sat,2/29/2020,679,344,335
990602,Sun,3/1/2020,552,273,279
990602,Mon,3/2/2020,634,315,319
990602,Tue,3/3/2020,737,371,366
990602,Wed,3/4/2020,711,361,350
990602,Thu,3/5/2020,709,354,355
990602,Fri,3/6/2020,879,446,433
990602,Sat,3/7/2020,688,349,339
990602,Sun,3/8/2020,652,322,330
990602,Mon,3/9/2020,665,329,336
990602,Tue,3/10/2020,678,345,333
990602,Wed,3/11/2020,691,340,351
990602,Thu,3/12/2020,674,333,341
990602,Fri,3/13/2020,765,392,373
990602,Sat,3/14/2020,553,269,284
990602,Sun,3/15/2020,541,266,275
990602,Mon,3/16/2020,623,312,311
990602,Tue,3/17/2020,631,317,314
990602,Wed,3/18/2020,636,311,325
990602,Thu,3/19/2020,535,271,264
990602,Fri,3/20/2020,614,303,311
990602,Sat,3/21/2020,513,259,254
990602,Sun,3/22/2020,377,189,188
990602,Mon,3/23/2020,543,264,279
990602,Tue,3/24/2020,466,231,235
990602,Wed,3/25/2020,513,252,261
990602,Thu,3/26/2020,539,267,272
990602,Fri,3/27/2020,558,277,281
990602,Sat,3/28/2020,485,241,244
990602,Sun,3/29/2020,482,228,254
990602,Mon,3/30/2020,578,290,288
990602,Tue,3/31/2020,510,251,259
990602,Wed,4/1/2020,569,281,288
990602,Thu,4/2/2020,547,272,275
990602,Fri,4/3/2020,711,361,350
990602,Sat,4/4/2020,519,258,261
990602,Sun,4/5/2020,435,213,222
990602,Mon,4/6/2020,562,279,283
990602,Tue,4/7/2020,604,305,299
990602,Wed,4/8/2020,656,328,328
990604,Wed,1/1/2020,519,269,250
990604,Thu,1/2/2020,789,392,397
990604,Fri,1/3/2020,838,409,429
990604,Sat,1/4/2020,618,324,294
990604,Sun,1/5/2020,572,285,287
990604,Mon,1/6/2020,838,394,444
990604,Tue,1/7/2020,901,444,457
990604,Wed,1/8/2020,989,502,487
990604,Thu,1/9/2020,936,495,441
990604,Fri,1/10/2020,740,375,365
990604,Sat,1/11/2020,587,289,298
990604,Sun,1/12/2020,508,255,253
990604,Mon,1/13/2020,814,399,415
990604,Tue,1/14/2020,815,415,400
990604,Wed,1/15/2020,856,430,426
990604,Thu,1/16/2020,862,436,426
990604,Fri,1/17/2020,903,445,458
990604,Sat,1/18/2020,602,296,306
990604,Sun,1/19/2020,479,245,234
990604,Mon,1/20/2020,743,376,367
990604,Tue,1/21/2020,901,448,453
990604,Wed,1/22/2020,817,405,412
990604,Thu,1/23/2020,858,422,436
990604,Fri,1/24/2020,787,387,400
990604,Sat,1/25/2020,595,316,279
990604,Sun,1/26/2020,500,257,243
990604,Mon,1/27/2020,816,403,413
990604,Tue,1/28/2020,806,414,392
990604,Thu,1/30/2020,807,421,386
990604,Fri,1/31/2020,857,435,422
990604,Sat,2/1/2020,641,318,323
990604,Sun,2/2/2020,586,296,290
990604,Mon,2/3/2020,780,385,395
990604,Tue,2/4/2020,736,377,359
990604,Wed,2/5/2020,771,388,383
990604,Thu,2/6/2020,771,373,398
990604,Fri,2/7/2020,884,444,440
990604,Sat,2/8/2020,597,306,291
990604,Sun,2/9/2020,513,256,257
990604,Mon,2/10/2020,785,387,398
990604,Tue,2/11/2020,879,433,446
990604,Wed,2/12/2020,738,362,376
990604,Thu,2/13/2020,824,410,414
990604,Fri,2/14/2020,814,414,400
990604,Sat,2/15/2020,635,336,299
990604,Sun,2/16/2020,610,307,303
990604,Mon,2/17/2020,672,319,353
990604,Tue,2/18/2020,783,392,391
990604,Wed,2/19/2020,797,401,396
990604,Thu,2/20/2020,774,377,397
990604,Fri,2/21/2020,801,400,401
990604,Sat,2/22/2020,775,407,368
990604,Sun,2/23/2020,604,293,311
990604,Mon,2/24/2020,724,352,372
990604,Thu,2/27/2020,788,383,405
990604,Fri,2/28/2020,832,419,413
990604,Sat,2/29/2020,673,346,327
990604,Sun,3/1/2020,628,336,292
990604,Mon,3/2/2020,655,317,338
990604,Tue,3/3/2020,791,397,394
990604,Wed,3/4/2020,774,396,378
990604,Thu,3/5/2020,800,407,393
990604,Fri,3/6/2020,883,450,433
990604,Sat,3/7/2020,664,347,317
990604,Sun,3/8/2020,731,343,388
990604,Mon,3/9/2020,725,352,373
990604,Tue,3/10/2020,793,401,392
990604,Wed,3/11/2020,784,391,393
990604,Thu,3/12/2020,781,389,392
990604,Fri,3/13/2020,785,399,386
990604,Sat,3/14/2020,533,263,270
990604,Sun,3/15/2020,515,269,246
990604,Mon,3/16/2020,681,331,350
990604,Tue,3/17/2020,728,376,352
990604,Wed,3/18/2020,637,337,300
990604,Thu,3/19/2020,595,301,294
990604,Fri,3/20/2020,685,357,328
990604,Sat,3/21/2020,553,284,269
990604,Sun,3/22/2020,429,221,208
990604,Mon,3/23/2020,599,292,307
990604,Tue,3/24/2020,609,317,292
990604,Wed,3/25/2020,619,303,316
990604,Thu,3/26/2020,693,353,340
990604,Fri,3/27/2020,708,352,356
990604,Sat,3/28/2020,567,290,277
990604,Sun,3/29/2020,508,263,245
990604,Mon,3/30/2020,639,312,327
990604,Tue,3/31/2020,619,320,299
990604,Wed,4/1/2020,612,307,305
990604,Thu,4/2/2020,785,385,400
990604,Fri,4/3/2020,765,396,369
990604,Sat,4/4/2020,625,313,312
990604,Sun,4/5/2020,479,245,234
990604,Mon,4/6/2020,605,307,298
990604,Tue,4/7/2020,662,328,334
990604,Wed,4/8/2020,729,361,368
990606,Wed,1/1/2020,2225,1114,1111
990606,Thu,1/2/2020,3336,1605,1731
990606,Fri,1/3/2020,3775,1843,1932
990606,Sat,1/4/2020,2891,1431,1460
990606,Sun,1/5/2020,2396,1205,1191
990606,Mon,1/6/2020,3533,1738,1795
990606,Tue,1/7/2020,3660,1791,1869
990606,Wed,1/8/2020,3523,1721,1802
990606,Thu,1/9/2020,3847,1885,1962
990606,Fri,1/10/2020,3647,1789,1858
990606,Sat,1/11/2020,2531,1249,1282
990606,Sun,1/12/2020,2400,1200,1200
990606,Mon,1/13/2020,3309,1604,1705
990606,Tue,1/14/2020,3699,1821,1878
990606,Wed,1/15/2020,3577,1748,1829
990606,Thu,1/16/2020,3789,1854,1935
990606,Fri,1/17/2020,3889,1922,1967
990606,Sat,1/18/2020,2893,1458,1435
990606,Sun,1/19/2020,2327,1146,1181
990606,Mon,1/20/2020,2721,1343,1378
990606,Tue,1/21/2020,3446,1694,1752
990606,Wed,1/22/2020,3651,1888,1763
990606,Thu,1/23/2020,3729,1878,1851
990606,Fri,1/24/2020,3824,1911,1913
990606,Sat,1/25/2020,2859,1418,1441
990606,Sun,1/26/2020,2341,1188,1153
990606,Mon,1/27/2020,3335,1654,1681
990606,Tue,1/28/2020,3365,1661,1704
990606,Thu,1/30/2020,3629,1811,1818
990606,Fri,1/31/2020,3947,1951,1996
990606,Sat,2/1/2020,3112,1566,1546
990606,Sun,2/2/2020,2667,1347,1320
990606,Mon,2/3/2020,3881,1960,1921
990606,Tue,2/4/2020,3482,1703,1779
990606,Wed,2/5/2020,3374,1680,1694
990606,Thu,2/6/2020,3609,1792,1817
990606,Fri,2/7/2020,3449,1677,1772
990606,Sat,2/8/2020,2771,1392,1379
990606,Sun,2/9/2020,2268,1126,1142
990606,Mon,2/10/2020,3254,1581,1673
990606,Tue,2/11/2020,3497,1727,1770
990606,Wed,2/12/2020,3240,1602,1638
990606,Thu,2/13/2020,3582,1774,1808
990606,Fri,2/14/2020,3759,1864,1895
990606,Sat,2/15/2020,3340,1722,1618
990606,Sun,2/16/2020,2435,1211,1224
990606,Mon,2/17/2020,3141,1541,1600
990606,Tue,2/18/2020,3468,1687,1781
990606,Wed,2/19/2020,3520,1742,1778
990606,Thu,2/20/2020,3697,1836,1861
990606,Fri,2/21/2020,3877,1919,1958
990606,Sat,2/22/2020,3288,1641,1647
990606,Sun,2/23/2020,2586,1303,1283
990606,Mon,2/24/2020,3705,1844,1861
990606,Thu,2/27/2020,3626,1816,1810
990606,Fri,2/28/2020,4040,2002,2038
990606,Sat,2/29/2020,3194,1600,1594
990606,Sun,3/1/2020,2857,1453,1404
990606,Mon,3/2/2020,3270,1599,1671
990606,Tue,3/3/2020,3769,1858,1911
990606,Wed,3/4/2020,3687,1822,1865
990606,Thu,3/5/2020,3731,1838,1893
990606,Fri,3/6/2020,4026,1987,2039
990606,Sat,3/7/2020,3491,1761,1730
990606,Sun,3/8/2020,2997,1511,1486
990606,Mon,3/9/2020,3560,1768,1792
990606,Tue,3/10/2020,3451,1692,1759
990606,Wed,3/11/2020,3779,1885,1894
990606,Thu,3/12/2020,3618,1804,1814
990606,Fri,3/13/2020,4212,2094,2118
990606,Sat,3/14/2020,2966,1466,1500
990606,Sun,3/15/2020,2427,1212,1215
990606,Mon,3/16/2020,3152,1543,1609
990606,Tue,3/17/2020,3339,1636,1703
990606,Wed,3/18/2020,3072,1527,1545
990606,Thu,3/19/2020,2946,1469,1477
990606,Fri,3/20/2020,3433,1668,1765
990606,Sat,3/21/2020,2709,1351,1358
990606,Sun,3/22/2020,1919,981,938
990606,Mon,3/23/2020,3112,1543,1569
990606,Tue,3/24/2020,2866,1407,1459
990606,Wed,3/25/2020,2388,1191,1197
990606,Thu,3/26/2020,2850,1409,1441
990606,Fri,3/27/2020,3014,1486,1528
990606,Sat,3/28/2020,2635,1298,1337
990606,Thu,4/2/2020,2811,1394,1417
990606,Fri,4/3/2020,3523,1687,1836
990606,Sat,4/4/2020,3135,1540,1595
990606,Sun,4/5/2020,2283,1194,1089
990606,Mon,4/6/2020,3035,1502,1533
990606,Tue,4/7/2020,2960,1470,1490
990607,Wed,1/1/2020,10009,5046,4963
990607,Thu,1/2/2020,20302,10462,9840
990607,Fri,1/3/2020,23134,11330,11804
990607,Sat,1/4/2020,15760,7233,8527
990607,Sun,1/5/2020,11877,5935,5942
990607,Mon,1/6/2020,20944,10812,10132
990607,Tue,1/7/2020,22566,11083,11483
990607,Wed,1/8/2020,22562,11027,11535
990607,Thu,1/9/2020,23155,11357,11798
990607,Fri,1/10/2020,24544,12112,12432
990607,Sat,1/11/2020,16304,7526,8778
990607,Sun,1/12/2020,12871,6318,6553
990607,Mon,1/13/2020,20759,10742,10017
990607,Tue,1/14/2020,22196,10993,11203
990607,Wed,1/15/2020,22365,10962,11403
990607,Thu,1/16/2020,22963,11414,11549
990607,Fri,1/17/2020,23381,11504,11877
990607,Sat,1/18/2020,16532,7616,8916
990607,Sun,1/19/2020,11290,5567,5723
990607,Mon,1/20/2020,19784,10127,9657
990607,Tue,1/21/2020,21965,10859,11106
990607,Wed,1/22/2020,21596,10814,10782
990607,Thu,1/23/2020,21502,10872,10630
990607,Fri,1/24/2020,22516,11350,11166
990607,Sat,1/25/2020,17117,7995,9122
990607,Sun,1/26/2020,12675,6424,6251
990607,Mon,1/27/2020,19780,10504,9276
990607,Tue,1/28/2020,21012,10561,10451
990607,Thu,1/30/2020,21965,11065,10900
990607,Fri,1/31/2020,23207,11596,11611
990607,Sat,2/1/2020,17158,8097,9061
990607,Sun,2/2/2020,11632,5764,5868
990607,Mon,2/3/2020,20226,10509,9717
990607,Tue,2/4/2020,21387,10582,10805
990607,Wed,2/5/2020,21615,10712,10903
990607,Thu,2/6/2020,21844,10819,11025
990607,Fri,2/7/2020,23273,11502,11771
990607,Sat,2/8/2020,17263,7988,9275
990607,Sun,2/9/2020,11470,5630,5840
990607,Mon,2/10/2020,19992,10346,9646
990607,Tue,2/11/2020,22116,10942,11174
990607,Wed,2/12/2020,21592,10643,10949
990607,Thu,2/13/2020,22456,11040,11416
990607,Fri,2/14/2020,23232,11614,11618
990607,Sat,2/15/2020,17917,8464,9453
990607,Sun,2/16/2020,13102,6591,6511
990607,Mon,2/17/2020,20557,10655,9902
990607,Tue,2/18/2020,21896,10798,11098
990607,Wed,2/19/2020,22283,11026,11257
990607,Thu,2/20/2020,22751,11284,11467
990607,Fri,2/21/2020,24181,11988,12193
990607,Sat,2/22/2020,18537,8657,9880
990607,Sun,2/23/2020,13433,6635,6798
990607,Mon,2/24/2020,19914,10329,9585
990607,Thu,2/27/2020,23012,11351,11661
990607,Fri,2/28/2020,24242,12001,12241
990607,Sat,2/29/2020,19041,8952,10089
990607,Sun,3/1/2020,13634,6806,6828
990607,Mon,3/2/2020,20585,10663,9922
990607,Tue,3/3/2020,23013,11184,11829
990607,Wed,3/4/2020,23048,11373,11675
990607,Thu,3/5/2020,23457,11639,11818
990607,Fri,3/6/2020,24875,12249,12626
990607,Sat,3/7/2020,18535,8651,9884
990607,Sun,3/8/2020,13138,6496,6642
990607,Mon,3/9/2020,20585,10671,9914
990607,Tue,3/10/2020,22807,11321,11486
990607,Wed,3/11/2020,22817,11231,11586
990607,Thu,3/12/2020,22126,10986,11140
990607,Fri,3/13/2020,24129,11810,12319
990607,Sat,3/14/2020,16523,7837,8686
990607,Sun,3/15/2020,11980,5822,6158
990607,Mon,3/16/2020,19873,10326,9547
990607,Tue,3/17/2020,20635,10236,10399
990607,Wed,3/18/2020,19580,9657,9923
990607,Thu,3/19/2020,19543,9697,9846
990607,Fri,3/20/2020,20226,9871,10355
990607,Sat,3/21/2020,11807,5497,6310
990607,Sun,3/22/2020,7158,3567,3591
990607,Mon,3/23/2020,13247,6626,6621
990607,Tue,3/24/2020,13250,6519,6731
990607,Wed,3/25/2020,11806,5772,6034
990607,Thu,3/26/2020,12157,6035,6122
990607,Fri,3/27/2020,12577,6191,6386
990607,Sat,3/28/2020,7854,3821,4033
990607,Sun,3/29/2020,6501,3227,3274
990607,Mon,3/30/2020,12230,6050,6180
990607,Tue,3/31/2020,12181,6023,6158
990607,Wed,4/1/2020,12426,6106,6320
990607,Thu,4/2/2020,12587,6261,6326
990607,Fri,4/3/2020,13224,6510,6714
990607,Sat,4/4/2020,8504,4173,4331
990607,Sun,4/5/2020,6571,3243,3328
990607,Mon,4/6/2020,12397,6163,6234
990607,Tue,4/7/2020,12910,6326,6584
990608,Wed,1/1/2020,10368,5202,5166
990608,Thu,1/2/2020,17814,8968,8846
990608,Fri,1/3/2020,19247,9652,9595
990608,Sat,1/4/2020,13923,6989,6934
990608,Sun,1/5/2020,11726,5838,5888
990608,Mon,1/6/2020,18555,9528,9027
990608,Tue,1/7/2020,19916,10080,9836
990608,Wed,1/8/2020,19715,9957,9758
990608,Fri,1/10/2020,19208,9769,9439
990608,Sat,1/11/2020,13333,6707,6626
990608,Sun,1/12/2020,11917,5994,5923
990608,Mon,1/13/2020,19623,9976,9647
990608,Tue,1/14/2020,20288,10220,10068
990608,Wed,1/15/2020,20462,10309,10153
990608,Thu,1/16/2020,19961,10053,9908
990608,Fri,1/17/2020,19915,10124,9791
990608,Sat,1/18/2020,14342,7267,7075
990608,Sun,1/19/2020,11472,5854,5618
990608,Mon,1/20/2020,16396,8326,8070
990608,Tue,1/21/2020,19698,9906,9792
990608,Wed,1/22/2020,20567,10043,10524
990608,Thu,1/23/2020,20126,10060,10066
990608,Fri,1/24/2020,20541,10157,10384
990608,Sat,1/25/2020,15018,7416,7602
990608,Sun,1/26/2020,12423,5995,6428
990608,Mon,1/27/2020,19306,9648,9658
990608,Tue,1/28/2020,19828,9893,9935
990608,Thu,1/30/2020,20335,10095,10240
990608,Fri,1/31/2020,21269,10592,10677
990608,Sat,2/1/2020,15539,7742,7797
990608,Sun,2/2/2020,13337,6618,6719
990608,Mon,2/3/2020,19712,9885,9827
990608,Tue,2/4/2020,19312,9707,9605
990608,Wed,2/5/2020,19394,9746,9648
990608,Thu,2/6/2020,19905,10044,9861
990608,Fri,2/7/2020,20211,10217,9994
990608,Sat,2/8/2020,15340,7684,7656
990608,Sun,2/9/2020,11826,5888,5938
990608,Mon,2/10/2020,18636,9394,9242
990608,Tue,2/11/2020,19872,10025,9847
990608,Wed,2/12/2020,19167,9582,9585
990608,Thu,2/13/2020,19914,10114,9800
990608,Fri,2/14/2020,20552,10435,10117
990608,Sat,2/15/2020,15814,8184,7630
990608,Sun,2/16/2020,13071,6546,6525
990608,Mon,2/17/2020,18249,9250,8999
990608,Tue,2/18/2020,19624,9828,9796
990608,Wed,2/19/2020,20538,10397,10141
990608,Thu,2/20/2020,20268,10066,10202
990608,Fri,2/21/2020,20958,10582,10376
990608,Sat,2/22/2020,15650,7854,7796
990608,Sun,2/23/2020,12697,6333,6364
990608,Mon,2/24/2020,18482,9410,9072
990608,Thu,2/27/2020,20621,10354,10267
990608,Fri,2/28/2020,20841,10461,10380
990608,Sat,2/29/2020,16010,7926,8084
990608,Sun,3/1/2020,13463,6623,6840
990608,Mon,3/2/2020,20708,9952,10756
990608,Tue,3/3/2020,22168,11056,11112
990608,Wed,3/4/2020,21917,10952,10965
990608,Thu,3/5/2020,22232,11127,11105
990608,Fri,3/6/2020,22371,11089,11282
990608,Sat,3/7/2020,17776,8572,9204
990608,Sun,3/8/2020,14228,7094,7134
990608,Mon,3/9/2020,19810,10087,9723
990608,Tue,3/10/2020,20444,10190,10254
990608,Wed,3/11/2020,21143,10451,10692
990608,Thu,3/12/2020,20117,10050,10067
990608,Fri,3/13/2020,21809,10856,10953
990608,Sat,3/14/2020,13631,6881,6750
990608,Sun,3/15/2020,11996,5921,6075
990608,Mon,3/16/2020,18463,9318,9145
990608,Tue,3/17/2020,18746,9402,9344
990608,Wed,3/18/2020,17234,8719,8515
990608,Thu,3/19/2020,16343,8214,8129
990608,Fri,3/20/2020,18010,8864,9146
990608,Sat,3/21/2020,12105,5971,6134
990608,Sun,3/22/2020,8763,4358,4405
990608,Mon,3/23/2020,15998,8037,7961
990608,Tue,3/24/2020,14787,7408,7379
990608,Wed,3/25/2020,13021,6605,6416
990608,Thu,3/26/2020,14040,7082,6958
990608,Fri,3/27/2020,14567,7278,7289
990608,Sat,3/28/2020,9909,4993,4916
990608,Sun,3/29/2020,8975,4517,4458
990608,Mon,3/30/2020,14172,7207,6965
990608,Tue,3/31/2020,13775,6896,6879
990608,Wed,4/1/2020,14660,7287,7373
990608,Thu,4/2/2020,14846,7364,7482
990608,Fri,4/3/2020,16164,7925,8239
990608,Sat,4/4/2020,11131,5563,5568
990608,Sun,4/5/2020,8847,4370,4477
990608,Mon,4/6/2020,14695,7316,7379
990608,Tue,4/7/2020,14664,7288,7376
990608,Wed,4/8/2020,14437,7138,7299
990609,Sun,3/12/2017,27897,13769,14128
